epi_week,week_start,week,cases,deaths,c_cases,c_deaths,district
21,13,2022-05-23,9,1,9,1,Balaka
22,14,2022-05-30,2,0,11,1,Balaka
23,15,2022-06-06,10,2,21,2,Balaka
24,16,2022-06-13,1,0,22,2,Balaka
25,17,2022-06-20,0,0,22,0,Balaka
26,18,2022-06-27,0,0,22,0,Balaka
27,19,2022-07-04,0,0,22,0,Balaka
28,20,2022-07-11,0,0,22,0,Balaka
29,21,2022-07-18,0,0,22,0,Balaka
30,22,2022-07-25,0,0,22,0,Balaka
31,23,2022-08-01,0,0,22,0,Balaka
32,24,2022-08-08,0,0,22,0,Balaka
33,25,2022-08-15,0,0,22,0,Balaka
34,26,2022-08-22,0,0,22,0,Balaka
35,27,2022-08-29,1,0,23,0,Balaka
36,28,2022-09-05,0,0,23,0,Balaka
37,29,2022-09-12,0,0,23,0,Balaka
38,30,2022-09-19,5,0,28,0,Balaka
39,31,2022-09-26,2,0,30,0,Balaka
40,32,2022-10-03,6,0,36,0,Balaka
41,33,2022-10-10,2,0,38,0,Balaka
42,34,2022-10-17,7,0,45,0,Balaka
43,35,2022-10-24,9,0,54,0,Balaka
44,36,2022-10-31,3,0,57,0,Balaka
45,37,2022-11-07,13,0,70,0,Balaka
46,38,2022-11-14,12,0,82,0,Balaka
47,39,2022-11-21,17,0,99,0,Balaka
48,40,2022-11-28,5,0,104,0,Balaka
49,41,2022-12-05,1,0,105,0,Balaka
50,42,2022-12-12,22,0,127,0,Balaka
51,43,2022-12-19,16,0,143,0,Balaka
52,44,2022-12-26,60,2,203,2,Balaka
1,45,2023-01-02,220,0,423,2,Balaka
2,46,2023-01-09,296,9,719,9,Balaka
3,47,2023-01-16,453,13,1172,22,Balaka
4,48,2023-01-23,462,12,1634,25,Balaka
5,49,2023-01-30,648,11,2282,23,Balaka
6,50,2023-02-06,501,14,2783,25,Balaka
7,51,2023-02-13,353,2,3136,16,Balaka
8,52,2023-02-20,302,6,3438,8,Balaka
9,53,2023-02-27,270,4,3708,10,Balaka
10,54,2023-03-06,144,2,3852,6,Balaka
11,55,2023-03-13,65,1,3917,3,Balaka
12,56,2023-03-20,38,1,3955,2,Balaka
13,57,2023-03-27,47,1,4002,2,Balaka
14,58,2023-04-03,29,0,4031,1,Balaka
15,59,2023-04-10,26,0,4057,0,Balaka
16,60,2023-04-17,29,0,4086,0,Balaka
17,61,2023-04-24,9,0,4095,0,Balaka
18,62,2023-05-01,6,0,4101,0,Balaka
19,63,2023-05-08,3,0,4104,0,Balaka
20,64,2023-05-15,8,1,4112,1,Balaka
21,65,2023-05-22,6,0,4118,1,Balaka
22,66,2023-05-29,2,0,4120,0,Balaka
23,67,2023-06-05,2,0,4122,0,Balaka
24,68,2023-06-12,6,0,4128,0,Balaka
25,69,2023-06-19,2,0,4130,0,Balaka
26,70,2023-06-26,0,0,4130,0,Balaka
27,71,2023-07-03,1,0,4131,0,Balaka
28,72,2023-07-10,1,0,4132,0,Balaka
29,73,2023-07-17,0,0,4132,0,Balaka
30,74,2023-07-24,0,0,4132,0,Balaka
31,75,2023-07-31,0,0,4132,0,Balaka
32,76,2023-08-07,0,0,4132,0,Balaka
33,77,2023-08-14,0,0,4132,0,Balaka
34,78,2023-08-21,0,0,4132,0,Balaka
35,79,2023-08-28,0,0,4132,0,Balaka
36,80,2023-09-04,0,0,4132,0,Balaka
37,81,2023-09-11,0,0,4132,0,Balaka
38,82,2023-09-18,0,0,4132,0,Balaka
39,83,2023-09-25,0,0,4132,0,Balaka
40,84,2023-10-02,0,0,4132,0,Balaka
41,85,2023-10-09,0,0,4132,0,Balaka
42,86,2023-10-16,0,0,4132,0,Balaka
43,87,2023-10-23,0,0,4132,0,Balaka
16,8,2022-04-18,3,0,3,0,Blantyre
17,9,2022-04-25,10,1,13,1,Blantyre
18,10,2022-05-02,26,1,39,2,Blantyre
19,11,2022-05-09,42,3,81,5,Blantyre
20,12,2022-05-16,38,2,119,7,Blantyre
21,13,2022-05-23,56,2,175,9,Blantyre
22,14,2022-05-30,47,4,222,13,Blantyre
23,15,2022-06-06,38,2,260,15,Blantyre
24,16,2022-06-13,25,0,285,15,Blantyre
25,17,2022-06-20,16,0,301,15,Blantyre
26,18,2022-06-27,18,0,319,15,Blantyre
27,19,2022-07-04,34,2,353,17,Blantyre
28,20,2022-07-11,44,1,397,18,Blantyre
29,21,2022-07-18,37,0,434,18,Blantyre
30,22,2022-07-25,21,0,455,18,Blantyre
31,23,2022-08-01,15,1,470,19,Blantyre
32,24,2022-08-08,40,2,510,21,Blantyre
33,25,2022-08-15,25,0,535,21,Blantyre
34,26,2022-08-22,18,0,553,21,Blantyre
35,27,2022-08-29,21,0,574,21,Blantyre
36,28,2022-09-05,8,1,582,22,Blantyre
37,29,2022-09-12,23,1,605,23,Blantyre
38,30,2022-09-19,17,1,622,24,Blantyre
39,31,2022-09-26,23,1,645,25,Blantyre
40,32,2022-10-03,32,1,677,26,Blantyre
41,33,2022-10-10,32,0,709,26,Blantyre
42,34,2022-10-17,9,1,718,27,Blantyre
43,35,2022-10-24,9,0,727,27,Blantyre
44,36,2022-10-31,7,0,734,27,Blantyre
45,37,2022-11-07,20,0,754,27,Blantyre
46,38,2022-11-14,20,1,774,28,Blantyre
47,39,2022-11-21,32,0,806,28,Blantyre
48,40,2022-11-28,55,2,861,30,Blantyre
49,41,2022-12-05,0,0,861,30,Blantyre
50,42,2022-12-12,207,10,1068,40,Blantyre
51,43,2022-12-19,468,29,1536,69,Blantyre
52,44,2022-12-26,777,24,2313,93,Blantyre
1,45,2023-01-02,634,12,2947,105,Blantyre
2,46,2023-01-09,811,2,3758,107,Blantyre
3,47,2023-01-16,663,7,4421,114,Blantyre
4,48,2023-01-23,674,17,5095,131,Blantyre
5,49,2023-01-30,627,17,5722,148,Blantyre
6,50,2023-02-06,479,1,6201,149,Blantyre
7,51,2023-02-13,400,7,6601,156,Blantyre
8,52,2023-02-20,377,2,6978,158,Blantyre
9,53,2023-02-27,313,4,7291,162,Blantyre
10,54,2023-03-06,306,2,7597,164,Blantyre
11,55,2023-03-13,224,6,7821,170,Blantyre
12,56,2023-03-20,271,4,8092,174,Blantyre
13,57,2023-03-27,225,1,8317,175,Blantyre
14,58,2023-04-03,206,5,8523,180,Blantyre
15,59,2023-04-10,179,1,8702,181,Blantyre
16,60,2023-04-17,147,5,8849,186,Blantyre
17,61,2023-04-24,65,4,8914,190,Blantyre
18,62,2023-05-01,30,0,8944,190,Blantyre
19,63,2023-05-08,21,0,8965,190,Blantyre
20,64,2023-05-15,13,0,8978,190,Blantyre
21,65,2023-05-22,9,0,8987,190,Blantyre
22,66,2023-05-29,2,0,8989,190,Blantyre
23,67,2023-06-05,0,0,8989,190,Blantyre
24,68,2023-06-12,5,0,8994,190,Blantyre
25,69,2023-06-19,1,0,8995,190,Blantyre
26,70,2023-06-26,0,0,8995,190,Blantyre
27,71,2023-07-03,0,0,8995,190,Blantyre
28,72,2023-07-10,0,0,8995,190,Blantyre
29,73,2023-07-17,1,0,8996,190,Blantyre
30,74,2023-07-24,0,0,8996,190,Blantyre
31,75,2023-07-31,0,0,8996,190,Blantyre
32,76,2023-08-07,0,0,8996,190,Blantyre
33,77,2023-08-14,0,0,8996,190,Blantyre
34,78,2023-08-21,1,0,8997,190,Blantyre
35,79,2023-08-28,0,0,8997,190,Blantyre
36,80,2023-09-04,0,0,8997,190,Blantyre
37,81,2023-09-11,0,0,8997,190,Blantyre
38,82,2023-09-18,0,0,8997,190,Blantyre
39,83,2023-09-25,0,0,8997,190,Blantyre
40,84,2023-10-02,0,0,8997,190,Blantyre
41,85,2023-10-09,0,0,8997,190,Blantyre
42,86,2023-10-16,0,0,8997,190,Blantyre
43,87,2023-10-23,0,0,8997,190,Blantyre
16,8,2022-04-18,2,0,2,0,Chikwawa
17,9,2022-04-25,3,0,5,0,Chikwawa
18,10,2022-05-02,7,0,12,0,Chikwawa
19,11,2022-05-09,10,0,22,0,Chikwawa
20,12,2022-05-16,10,0,32,0,Chikwawa
21,13,2022-05-23,15,0,47,0,Chikwawa
22,14,2022-05-30,6,0,53,0,Chikwawa
23,15,2022-06-06,6,0,59,0,Chikwawa
24,16,2022-06-13,5,0,64,0,Chikwawa
25,17,2022-06-20,5,0,69,0,Chikwawa
26,18,2022-06-27,4,1,73,1,Chikwawa
27,19,2022-07-04,10,0,83,1,Chikwawa
28,20,2022-07-11,6,0,89,1,Chikwawa
29,21,2022-07-18,8,0,97,1,Chikwawa
30,22,2022-07-25,19,0,116,1,Chikwawa
31,23,2022-08-01,13,0,129,1,Chikwawa
32,24,2022-08-08,0,0,129,1,Chikwawa
33,25,2022-08-15,0,0,129,1,Chikwawa
34,26,2022-08-22,2,0,131,1,Chikwawa
35,27,2022-08-29,12,2,143,3,Chikwawa
36,28,2022-09-05,20,1,163,4,Chikwawa
37,29,2022-09-12,7,0,170,4,Chikwawa
38,30,2022-09-19,3,0,173,4,Chikwawa
39,31,2022-09-26,7,0,180,4,Chikwawa
40,32,2022-10-03,6,0,186,4,Chikwawa
41,33,2022-10-10,7,0,193,4,Chikwawa
42,34,2022-10-17,8,0,201,4,Chikwawa
43,35,2022-10-24,15,0,216,4,Chikwawa
44,36,2022-10-31,1,0,217,4,Chikwawa
45,37,2022-11-07,0,0,217,4,Chikwawa
46,38,2022-11-14,5,0,222,4,Chikwawa
47,39,2022-11-21,2,0,224,4,Chikwawa
48,40,2022-11-28,0,0,224,4,Chikwawa
49,41,2022-12-05,2,0,226,4,Chikwawa
50,42,2022-12-12,0,0,226,4,Chikwawa
51,43,2022-12-19,4,1,230,5,Chikwawa
52,44,2022-12-26,4,0,234,5,Chikwawa
1,45,2023-01-02,8,1,242,6,Chikwawa
2,46,2023-01-09,27,0,269,6,Chikwawa
3,47,2023-01-16,42,1,311,7,Chikwawa
4,48,2023-01-23,19,0,330,7,Chikwawa
5,49,2023-01-30,33,0,363,7,Chikwawa
6,50,2023-02-06,26,0,389,7,Chikwawa
7,51,2023-02-13,39,0,428,7,Chikwawa
8,52,2023-02-20,37,0,465,7,Chikwawa
9,53,2023-02-27,29,0,494,7,Chikwawa
10,54,2023-03-06,30,1,524,8,Chikwawa
11,55,2023-03-13,16,1,540,9,Chikwawa
12,56,2023-03-20,25,0,565,9,Chikwawa
13,57,2023-03-27,26,1,591,10,Chikwawa
14,58,2023-04-03,36,0,627,10,Chikwawa
15,59,2023-04-10,23,0,650,10,Chikwawa
16,60,2023-04-17,17,0,667,10,Chikwawa
17,61,2023-04-24,12,0,679,10,Chikwawa
18,62,2023-05-01,28,0,707,10,Chikwawa
19,63,2023-05-08,28,0,735,10,Chikwawa
20,64,2023-05-15,19,1,754,11,Chikwawa
21,65,2023-05-22,17,0,771,11,Chikwawa
22,66,2023-05-29,24,0,795,11,Chikwawa
23,67,2023-06-05,34,0,829,11,Chikwawa
24,68,2023-06-12,31,1,860,12,Chikwawa
25,69,2023-06-19,11,0,871,12,Chikwawa
26,70,2023-06-26,18,1,889,13,Chikwawa
27,71,2023-07-03,5,1,894,14,Chikwawa
28,72,2023-07-10,4,0,898,14,Chikwawa
29,73,2023-07-17,4,0,902,14,Chikwawa
30,74,2023-07-24,10,2,912,16,Chikwawa
31,75,2023-07-31,7,0,919,16,Chikwawa
32,76,2023-08-07,1,0,920,16,Chikwawa
33,77,2023-08-14,3,0,923,16,Chikwawa
34,78,2023-08-21,5,0,928,16,Chikwawa
35,79,2023-08-28,3,0,931,16,Chikwawa
36,80,2023-09-04,3,0,934,16,Chikwawa
37,81,2023-09-11,2,0,936,16,Chikwawa
38,82,2023-09-18,0,0,936,16,Chikwawa
39,83,2023-09-25,0,0,936,16,Chikwawa
40,84,2023-10-02,0,0,936,16,Chikwawa
41,85,2023-10-09,0,0,936,16,Chikwawa
42,86,2023-10-16,0,0,936,16,Chikwawa
43,87,2023-10-23,0,0,936,16,Chikwawa
25,17,2022-06-20,1,0,1,0,Chiradzulu
26,18,2022-06-27,3,0,4,0,Chiradzulu
27,19,2022-07-04,0,0,4,0,Chiradzulu
28,20,2022-07-11,0,0,4,0,Chiradzulu
29,21,2022-07-18,1,0,5,0,Chiradzulu
30,22,2022-07-25,0,0,5,0,Chiradzulu
31,23,2022-08-01,0,0,5,0,Chiradzulu
32,24,2022-08-08,0,0,5,0,Chiradzulu
33,25,2022-08-15,0,0,5,0,Chiradzulu
34,26,2022-08-22,0,0,5,0,Chiradzulu
35,27,2022-08-29,0,0,5,0,Chiradzulu
36,28,2022-09-05,0,0,5,0,Chiradzulu
37,29,2022-09-12,3,0,8,0,Chiradzulu
38,30,2022-09-19,0,0,8,0,Chiradzulu
39,31,2022-09-26,0,0,8,0,Chiradzulu
40,32,2022-10-03,2,0,10,0,Chiradzulu
41,33,2022-10-10,0,0,10,0,Chiradzulu
42,34,2022-10-17,0,0,10,0,Chiradzulu
43,35,2022-10-24,0,0,10,0,Chiradzulu
44,36,2022-10-31,0,0,10,0,Chiradzulu
45,37,2022-11-07,0,0,10,0,Chiradzulu
46,38,2022-11-14,0,0,10,0,Chiradzulu
47,39,2022-11-21,0,0,10,0,Chiradzulu
48,40,2022-11-28,8,0,18,0,Chiradzulu
49,41,2022-12-05,3,0,21,0,Chiradzulu
50,42,2022-12-12,7,0,28,0,Chiradzulu
51,43,2022-12-19,31,0,59,0,Chiradzulu
52,44,2022-12-26,56,2,115,2,Chiradzulu
1,45,2023-01-02,64,4,179,6,Chiradzulu
2,46,2023-01-09,110,5,289,11,Chiradzulu
3,47,2023-01-16,155,7,444,18,Chiradzulu
4,48,2023-01-23,225,6,669,24,Chiradzulu
5,49,2023-01-30,187,6,856,30,Chiradzulu
6,50,2023-02-06,193,3,1049,33,Chiradzulu
7,51,2023-02-13,110,0,1159,33,Chiradzulu
8,52,2023-02-20,104,2,1263,35,Chiradzulu
9,53,2023-02-27,57,3,1320,38,Chiradzulu
10,54,2023-03-06,34,1,1354,39,Chiradzulu
11,55,2023-03-13,13,1,1367,40,Chiradzulu
12,56,2023-03-20,14,0,1381,40,Chiradzulu
13,57,2023-03-27,16,1,1397,41,Chiradzulu
14,58,2023-04-03,7,0,1404,41,Chiradzulu
15,59,2023-04-10,10,0,1414,41,Chiradzulu
16,60,2023-04-17,7,0,1421,41,Chiradzulu
17,61,2023-04-24,4,0,1425,41,Chiradzulu
18,62,2023-05-01,1,0,1426,41,Chiradzulu
19,63,2023-05-08,0,0,1426,41,Chiradzulu
20,64,2023-05-15,0,0,1426,41,Chiradzulu
21,65,2023-05-22,0,0,1426,41,Chiradzulu
22,66,2023-05-29,0,0,1426,41,Chiradzulu
23,67,2023-06-05,0,0,1426,41,Chiradzulu
24,68,2023-06-12,0,0,1426,41,Chiradzulu
25,69,2023-06-19,0,0,1426,41,Chiradzulu
26,70,2023-06-26,0,0,1426,41,Chiradzulu
27,71,2023-07-03,0,0,1426,41,Chiradzulu
28,72,2023-07-10,0,0,1426,41,Chiradzulu
29,73,2023-07-17,0,0,1426,41,Chiradzulu
30,74,2023-07-24,0,0,1426,41,Chiradzulu
31,75,2023-07-31,0,0,1426,41,Chiradzulu
32,76,2023-08-07,0,0,1426,41,Chiradzulu
33,77,2023-08-14,0,0,1426,41,Chiradzulu
34,78,2023-08-21,0,0,1426,41,Chiradzulu
35,79,2023-08-28,0,0,1426,41,Chiradzulu
36,80,2023-09-04,0,0,1426,41,Chiradzulu
37,81,2023-09-11,0,0,1426,41,Chiradzulu
38,82,2023-09-18,0,0,1426,41,Chiradzulu
39,83,2023-09-25,0,0,1426,41,Chiradzulu
40,84,2023-10-02,0,0,1426,41,Chiradzulu
41,85,2023-10-09,0,0,1426,41,Chiradzulu
42,86,2023-10-16,1,0,1427,41,Chiradzulu
43,87,2023-10-23,0,0,1427,41,Chiradzulu
43,35,2022-10-24,11,0,11,0,Chitipa
44,36,2022-10-31,15,0,26,0,Chitipa
45,37,2022-11-07,32,1,58,1,Chitipa
46,38,2022-11-14,14,2,72,3,Chitipa
47,39,2022-11-21,3,0,75,3,Chitipa
48,40,2022-11-28,9,0,84,3,Chitipa
49,41,2022-12-05,3,0,87,3,Chitipa
50,42,2022-12-12,0,0,87,3,Chitipa
51,43,2022-12-19,0,0,87,3,Chitipa
52,44,2022-12-26,0,0,87,3,Chitipa
1,45,2023-01-02,0,0,87,3,Chitipa
2,46,2023-01-09,2,0,89,3,Chitipa
3,47,2023-01-16,1,0,90,3,Chitipa
4,48,2023-01-23,1,0,91,3,Chitipa
5,49,2023-01-30,NA,NA,91,3,Chitipa
6,50,2023-02-06,NA,NA,91,3,Chitipa
7,51,2023-02-13,0,0,91,3,Chitipa
8,52,2023-02-20,0,0,91,3,Chitipa
9,53,2023-02-27,0,0,91,3,Chitipa
10,54,2023-03-06,0,0,91,3,Chitipa
11,55,2023-03-13,0,0,91,3,Chitipa
12,56,2023-03-20,0,0,91,3,Chitipa
13,57,2023-03-27,0,0,91,3,Chitipa
14,58,2023-04-03,0,0,91,3,Chitipa
15,59,2023-04-10,0,0,91,3,Chitipa
16,60,2023-04-17,0,0,91,3,Chitipa
17,61,2023-04-24,0,0,91,3,Chitipa
18,62,2023-05-01,0,0,91,3,Chitipa
19,63,2023-05-08,0,0,91,3,Chitipa
20,64,2023-05-15,0,0,91,3,Chitipa
21,65,2023-05-22,0,0,91,3,Chitipa
22,66,2023-05-29,0,0,91,3,Chitipa
23,67,2023-06-05,0,0,91,3,Chitipa
24,68,2023-06-12,0,0,91,3,Chitipa
25,69,2023-06-19,0,0,91,3,Chitipa
26,70,2023-06-26,0,0,91,3,Chitipa
27,71,2023-07-03,0,0,91,3,Chitipa
28,72,2023-07-10,0,0,91,3,Chitipa
29,73,2023-07-17,0,0,91,3,Chitipa
30,74,2023-07-24,0,0,91,3,Chitipa
31,75,2023-07-31,0,0,91,3,Chitipa
32,76,2023-08-07,0,0,91,3,Chitipa
33,77,2023-08-14,0,0,91,3,Chitipa
34,78,2023-08-21,0,0,91,3,Chitipa
35,79,2023-08-28,0,0,91,3,Chitipa
36,80,2023-09-04,0,0,91,3,Chitipa
37,81,2023-09-11,0,0,91,3,Chitipa
38,82,2023-09-18,0,0,91,3,Chitipa
39,83,2023-09-25,0,0,91,3,Chitipa
40,84,2023-10-02,0,0,91,3,Chitipa
41,85,2023-10-09,0,0,91,3,Chitipa
42,86,2023-10-16,0,0,91,3,Chitipa
43,87,2023-10-23,0,0,91,3,Chitipa
45,37,2022-11-07,1,0,1,0,Dedza
46,38,2022-11-14,65,5,66,5,Dedza
47,39,2022-11-21,67,3,133,8,Dedza
48,40,2022-11-28,40,0,173,8,Dedza
49,41,2022-12-05,42,5,215,13,Dedza
50,42,2022-12-12,73,1,288,14,Dedza
51,43,2022-12-19,127,2,415,16,Dedza
52,44,2022-12-26,132,5,547,21,Dedza
1,45,2023-01-02,116,7,663,28,Dedza
2,46,2023-01-09,156,9,819,37,Dedza
3,47,2023-01-16,137,15,956,52,Dedza
4,48,2023-01-23,95,6,1051,58,Dedza
5,49,2023-01-30,179,6,1230,64,Dedza
6,50,2023-02-06,129,5,1359,69,Dedza
7,51,2023-02-13,122,4,1481,73,Dedza
8,52,2023-02-20,139,5,1620,78,Dedza
9,53,2023-02-27,104,6,1724,84,Dedza
10,54,2023-03-06,90,0,1814,84,Dedza
11,55,2023-03-13,105,2,1919,86,Dedza
12,56,2023-03-20,53,4,1972,90,Dedza
13,57,2023-03-27,49,2,2021,92,Dedza
14,58,2023-04-03,42,1,2063,93,Dedza
15,59,2023-04-10,14,0,2077,93,Dedza
16,60,2023-04-17,10,1,2087,94,Dedza
17,61,2023-04-24,25,1,2112,95,Dedza
18,62,2023-05-01,12,0,2124,95,Dedza
19,63,2023-05-08,0,0,2124,95,Dedza
20,64,2023-05-15,0,0,2124,95,Dedza
21,65,2023-05-22,0,0,2124,95,Dedza
22,66,2023-05-29,0,0,2124,95,Dedza
23,67,2023-06-05,0,0,2124,95,Dedza
24,68,2023-06-12,0,0,2124,95,Dedza
25,69,2023-06-19,0,0,2124,95,Dedza
26,70,2023-06-26,0,0,2124,95,Dedza
27,71,2023-07-03,0,0,2124,95,Dedza
28,72,2023-07-10,0,0,2124,95,Dedza
29,73,2023-07-17,0,0,2124,95,Dedza
30,74,2023-07-24,0,0,2124,95,Dedza
31,75,2023-07-31,0,0,2124,95,Dedza
32,76,2023-08-07,0,0,2124,95,Dedza
33,77,2023-08-14,0,0,2124,95,Dedza
34,78,2023-08-21,0,0,2124,95,Dedza
35,79,2023-08-28,0,0,2124,95,Dedza
36,80,2023-09-04,0,0,2124,95,Dedza
37,81,2023-09-11,0,0,2124,95,Dedza
38,82,2023-09-18,0,0,2124,95,Dedza
39,83,2023-09-25,0,0,2124,95,Dedza
40,84,2023-10-02,0,0,2124,95,Dedza
41,85,2023-10-09,0,0,2124,95,Dedza
42,86,2023-10-16,0,0,2124,95,Dedza
43,87,2023-10-23,0,0,2124,95,Dedza
43,35,2022-10-24,2,0,2,0,Dowa
44,36,2022-10-31,2,0,4,0,Dowa
45,37,2022-11-07,1,0,5,0,Dowa
46,38,2022-11-14,1,1,6,1,Dowa
47,39,2022-11-21,7,0,13,1,Dowa
48,40,2022-11-28,0,0,13,1,Dowa
49,41,2022-12-05,0,0,13,1,Dowa
50,42,2022-12-12,0,0,13,1,Dowa
51,43,2022-12-19,196,5,209,6,Dowa
52,44,2022-12-26,305,7,514,13,Dowa
1,45,2023-01-02,119,6,633,19,Dowa
2,46,2023-01-09,93,0,726,19,Dowa
3,47,2023-01-16,56,2,782,21,Dowa
4,48,2023-01-23,72,0,854,21,Dowa
5,49,2023-01-30,137,7,991,28,Dowa
6,50,2023-02-06,102,4,1093,32,Dowa
7,51,2023-02-13,83,3,1176,35,Dowa
8,52,2023-02-20,77,2,1253,37,Dowa
9,53,2023-02-27,48,1,1301,38,Dowa
10,54,2023-03-06,27,1,1328,39,Dowa
11,55,2023-03-13,11,0,1339,39,Dowa
12,56,2023-03-20,5,0,1344,39,Dowa
13,57,2023-03-27,1,0,1345,39,Dowa
14,58,2023-04-03,4,0,1349,39,Dowa
15,59,2023-04-10,0,0,1349,39,Dowa
16,60,2023-04-17,0,0,1349,39,Dowa
17,61,2023-04-24,0,0,1349,39,Dowa
18,62,2023-05-01,0,0,1349,39,Dowa
19,63,2023-05-08,0,0,1349,39,Dowa
20,64,2023-05-15,0,0,1349,39,Dowa
21,65,2023-05-22,0,0,1349,39,Dowa
22,66,2023-05-29,0,0,1349,39,Dowa
23,67,2023-06-05,0,0,1349,39,Dowa
24,68,2023-06-12,0,0,1349,39,Dowa
25,69,2023-06-19,0,0,1349,39,Dowa
26,70,2023-06-26,0,0,1349,39,Dowa
27,71,2023-07-03,0,0,1349,39,Dowa
28,72,2023-07-10,0,0,1349,39,Dowa
29,73,2023-07-17,0,0,1349,39,Dowa
30,74,2023-07-24,0,0,1349,39,Dowa
31,75,2023-07-31,0,0,1349,39,Dowa
32,76,2023-08-07,0,0,1349,39,Dowa
33,77,2023-08-14,0,0,1349,39,Dowa
34,78,2023-08-21,0,0,1349,39,Dowa
35,79,2023-08-28,0,0,1349,39,Dowa
36,80,2023-09-04,0,0,1349,39,Dowa
37,81,2023-09-11,0,0,1349,39,Dowa
38,82,2023-09-18,0,0,1349,39,Dowa
39,83,2023-09-25,0,0,1349,39,Dowa
40,84,2023-10-02,0,0,1349,39,Dowa
41,85,2023-10-09,0,0,1349,39,Dowa
42,86,2023-10-16,0,0,1349,39,Dowa
43,87,2023-10-23,0,0,1349,39,Dowa
NA,NA,NA,0,0,NA,NA,Dowa
34,26,2022-08-22,2,0,2,0,Karonga
35,27,2022-08-29,65,3,67,3,Karonga
36,28,2022-09-05,70,1,137,4,Karonga
37,29,2022-09-12,61,1,198,5,Karonga
38,30,2022-09-19,83,0,281,5,Karonga
39,31,2022-09-26,129,2,410,7,Karonga
40,32,2022-10-03,194,5,604,12,Karonga
41,33,2022-10-10,72,1,676,13,Karonga
42,34,2022-10-17,117,3,793,16,Karonga
43,35,2022-10-24,98,1,891,17,Karonga
44,36,2022-10-31,100,0,991,17,Karonga
45,37,2022-11-07,72,0,1063,17,Karonga
46,38,2022-11-14,61,2,1124,19,Karonga
47,39,2022-11-21,31,0,1155,19,Karonga
48,40,2022-11-28,70,1,1225,20,Karonga
49,41,2022-12-05,62,3,1287,23,Karonga
50,42,2022-12-12,15,0,1302,23,Karonga
51,43,2022-12-19,14,0,1316,23,Karonga
52,44,2022-12-26,20,2,1336,25,Karonga
1,45,2023-01-02,13,0,1349,25,Karonga
2,46,2023-01-09,7,0,1356,25,Karonga
3,47,2023-01-16,7,0,1363,25,Karonga
4,48,2023-01-23,6,0,1369,25,Karonga
5,49,2023-01-30,4,0,1373,25,Karonga
6,50,2023-02-06,6,0,1379,25,Karonga
7,51,2023-02-13,2,0,1381,25,Karonga
8,52,2023-02-20,8,0,1389,25,Karonga
9,53,2023-02-27,7,0,1396,25,Karonga
10,54,2023-03-06,0,0,1396,25,Karonga
11,55,2023-03-13,0,0,1396,25,Karonga
12,56,2023-03-20,2,0,1398,25,Karonga
13,57,2023-03-27,0,0,1398,25,Karonga
14,58,2023-04-03,1,0,1399,25,Karonga
15,59,2023-04-10,0,0,1399,25,Karonga
16,60,2023-04-17,1,0,1400,25,Karonga
17,61,2023-04-24,1,0,1401,25,Karonga
18,62,2023-05-01,2,0,1403,25,Karonga
19,63,2023-05-08,0,0,1403,25,Karonga
20,64,2023-05-15,0,0,1403,25,Karonga
21,65,2023-05-22,2,0,1405,25,Karonga
22,66,2023-05-29,0,0,1405,25,Karonga
23,67,2023-06-05,0,0,1405,25,Karonga
24,68,2023-06-12,0,0,1405,25,Karonga
25,69,2023-06-19,0,0,1405,25,Karonga
26,70,2023-06-26,0,0,1405,25,Karonga
27,71,2023-07-03,0,0,1405,25,Karonga
28,72,2023-07-10,0,0,1405,25,Karonga
29,73,2023-07-17,0,0,1405,25,Karonga
30,74,2023-07-24,0,0,1405,25,Karonga
31,75,2023-07-31,0,0,1405,25,Karonga
32,76,2023-08-07,0,0,1405,25,Karonga
33,77,2023-08-14,0,0,1405,25,Karonga
34,78,2023-08-21,0,0,1405,25,Karonga
35,79,2023-08-28,0,0,1405,25,Karonga
36,80,2023-09-04,0,0,1405,25,Karonga
37,81,2023-09-11,0,0,1405,25,Karonga
38,82,2023-09-18,1,0,1406,25,Karonga
39,83,2023-09-25,0,0,1406,25,Karonga
40,84,2023-10-02,0,0,1406,25,Karonga
41,85,2023-10-09,0,0,1406,25,Karonga
42,86,2023-10-16,0,0,1406,25,Karonga
43,87,2023-10-23,0,0,1406,25,Karonga
35,27,2022-08-29,2,0,2,0,Kasungu
36,28,2022-09-05,0,1,2,1,Kasungu
37,29,2022-09-12,0,0,2,1,Kasungu
38,30,2022-09-19,2,0,4,1,Kasungu
39,31,2022-09-26,0,0,4,1,Kasungu
40,32,2022-10-03,0,0,4,1,Kasungu
41,33,2022-10-10,0,0,4,1,Kasungu
42,34,2022-10-17,3,0,7,1,Kasungu
43,35,2022-10-24,0,0,7,1,Kasungu
44,36,2022-10-31,0,0,7,1,Kasungu
45,37,2022-11-07,1,0,8,1,Kasungu
46,38,2022-11-14,0,0,8,1,Kasungu
47,39,2022-11-21,1,0,9,1,Kasungu
48,40,2022-11-28,0,0,9,1,Kasungu
49,41,2022-12-05,0,0,9,1,Kasungu
50,42,2022-12-12,0,0,9,1,Kasungu
51,43,2022-12-19,0,0,9,1,Kasungu
52,44,2022-12-26,0,0,9,1,Kasungu
1,45,2023-01-02,7,0,16,1,Kasungu
2,46,2023-01-09,5,0,21,1,Kasungu
3,47,2023-01-16,1,0,22,1,Kasungu
4,48,2023-01-23,4,0,26,1,Kasungu
5,49,2023-01-30,1,0,27,1,Kasungu
6,50,2023-02-06,3,0,30,1,Kasungu
7,51,2023-02-13,1,0,31,1,Kasungu
8,52,2023-02-20,4,0,35,1,Kasungu
9,53,2023-02-27,4,0,39,1,Kasungu
10,54,2023-03-06,11,2,50,3,Kasungu
11,55,2023-03-13,12,2,62,5,Kasungu
12,56,2023-03-20,9,0,71,5,Kasungu
13,57,2023-03-27,13,1,84,6,Kasungu
14,58,2023-04-03,3,0,87,6,Kasungu
15,59,2023-04-10,3,0,90,6,Kasungu
16,60,2023-04-17,0,0,90,6,Kasungu
17,61,2023-04-24,0,0,90,6,Kasungu
18,62,2023-05-01,0,0,90,6,Kasungu
19,63,2023-05-08,0,0,90,6,Kasungu
20,64,2023-05-15,0,0,90,6,Kasungu
21,65,2023-05-22,0,0,90,6,Kasungu
22,66,2023-05-29,0,0,90,6,Kasungu
23,67,2023-06-05,0,0,90,6,Kasungu
24,68,2023-06-12,0,0,90,6,Kasungu
25,69,2023-06-19,0,0,90,6,Kasungu
26,70,2023-06-26,0,0,90,6,Kasungu
27,71,2023-07-03,0,0,90,6,Kasungu
28,72,2023-07-10,0,0,90,6,Kasungu
29,73,2023-07-17,0,0,90,6,Kasungu
30,74,2023-07-24,0,0,90,6,Kasungu
31,75,2023-07-31,0,0,90,6,Kasungu
32,76,2023-08-07,0,0,90,6,Kasungu
33,77,2023-08-14,0,0,90,6,Kasungu
34,78,2023-08-21,0,0,90,6,Kasungu
35,79,2023-08-28,0,0,90,6,Kasungu
36,80,2023-09-04,0,0,90,6,Kasungu
37,81,2023-09-11,0,0,90,6,Kasungu
38,82,2023-09-18,0,0,90,6,Kasungu
39,83,2023-09-25,0,0,90,6,Kasungu
40,84,2023-10-02,0,0,90,6,Kasungu
41,85,2023-10-09,0,0,90,6,Kasungu
42,86,2023-10-16,0,0,90,6,Kasungu
43,87,2023-10-23,0,0,90,6,Kasungu
37,29,2022-09-12,12,1,12,1,Likoma
38,30,2022-09-19,19,1,31,2,Likoma
39,31,2022-09-26,8,0,39,2,Likoma
40,32,2022-10-03,21,0,60,2,Likoma
41,33,2022-10-10,7,0,67,2,Likoma
42,34,2022-10-17,8,0,75,2,Likoma
43,35,2022-10-24,20,0,95,2,Likoma
44,36,2022-10-31,25,0,120,2,Likoma
45,37,2022-11-07,8,0,128,2,Likoma
46,38,2022-11-14,5,0,133,2,Likoma
47,39,2022-11-21,1,0,134,2,Likoma
48,40,2022-11-28,0,0,134,2,Likoma
49,41,2022-12-05,0,0,134,2,Likoma
50,42,2022-12-12,0,0,134,2,Likoma
51,43,2022-12-19,0,0,134,2,Likoma
52,44,2022-12-26,3,0,137,2,Likoma
1,45,2023-01-02,6,0,143,2,Likoma
2,46,2023-01-09,15,0,158,2,Likoma
3,47,2023-01-16,11,0,169,2,Likoma
4,48,2023-01-23,13,0,182,2,Likoma
5,49,2023-01-30,8,0,190,2,Likoma
6,50,2023-02-06,5,0,195,2,Likoma
7,51,2023-02-13,2,0,197,2,Likoma
8,52,2023-02-20,2,0,199,2,Likoma
9,53,2023-02-27,2,0,201,2,Likoma
10,54,2023-03-06,3,0,204,2,Likoma
11,55,2023-03-13,0,0,204,2,Likoma
12,56,2023-03-20,0,0,204,2,Likoma
13,57,2023-03-27,0,0,204,2,Likoma
14,58,2023-04-03,0,0,204,2,Likoma
15,59,2023-04-10,0,0,204,2,Likoma
16,60,2023-04-17,0,0,204,2,Likoma
17,61,2023-04-24,0,0,204,2,Likoma
18,62,2023-05-01,0,0,204,2,Likoma
19,63,2023-05-08,0,0,204,2,Likoma
20,64,2023-05-15,0,0,204,2,Likoma
21,65,2023-05-22,0,0,204,2,Likoma
22,66,2023-05-29,0,0,204,2,Likoma
23,67,2023-06-05,0,0,204,2,Likoma
24,68,2023-06-12,0,0,204,2,Likoma
25,69,2023-06-19,0,0,204,2,Likoma
26,70,2023-06-26,0,0,204,2,Likoma
27,71,2023-07-03,0,0,204,2,Likoma
28,72,2023-07-10,0,0,204,2,Likoma
29,73,2023-07-17,0,0,204,2,Likoma
30,74,2023-07-24,0,0,204,2,Likoma
31,75,2023-07-31,0,0,204,2,Likoma
32,76,2023-08-07,0,0,204,2,Likoma
33,77,2023-08-14,0,0,204,2,Likoma
34,78,2023-08-21,0,0,204,2,Likoma
35,79,2023-08-28,0,0,204,2,Likoma
36,80,2023-09-04,0,0,204,2,Likoma
37,81,2023-09-11,0,0,204,2,Likoma
38,82,2023-09-18,0,0,204,2,Likoma
39,83,2023-09-25,0,0,204,2,Likoma
40,84,2023-10-02,0,0,204,2,Likoma
41,85,2023-10-09,0,0,204,2,Likoma
42,86,2023-10-16,0,0,204,2,Likoma
43,87,2023-10-23,0,0,204,2,Likoma
21,13,2022-05-23,0,0,0,0,Lilongwe
22,14,2022-05-30,0,0,0,0,Lilongwe
23,15,2022-06-06,0,0,0,0,Lilongwe
24,16,2022-06-13,1,0,1,0,Lilongwe
25,17,2022-06-20,0,0,1,0,Lilongwe
26,18,2022-06-27,0,0,1,0,Lilongwe
27,19,2022-07-04,0,0,1,0,Lilongwe
28,20,2022-07-11,0,0,1,0,Lilongwe
29,21,2022-07-18,0,0,1,0,Lilongwe
30,22,2022-07-25,0,0,1,0,Lilongwe
31,23,2022-08-01,1,0,2,0,Lilongwe
32,24,2022-08-08,1,1,3,1,Lilongwe
33,25,2022-08-15,0,0,3,1,Lilongwe
34,26,2022-08-22,0,0,3,1,Lilongwe
35,27,2022-08-29,1,0,4,1,Lilongwe
36,28,2022-09-05,0,0,4,1,Lilongwe
37,29,2022-09-12,1,0,5,1,Lilongwe
38,30,2022-09-19,0,0,5,1,Lilongwe
39,31,2022-09-26,0,0,5,1,Lilongwe
40,32,2022-10-03,1,0,6,1,Lilongwe
41,33,2022-10-10,5,0,11,1,Lilongwe
42,34,2022-10-17,10,0,21,1,Lilongwe
43,35,2022-10-24,11,0,32,1,Lilongwe
44,36,2022-10-31,9,5,41,6,Lilongwe
45,37,2022-11-07,17,1,58,7,Lilongwe
46,38,2022-11-14,25,4,83,11,Lilongwe
47,39,2022-11-21,75,15,158,26,Lilongwe
48,40,2022-11-28,49,1,207,27,Lilongwe
49,41,2022-12-05,70,5,277,32,Lilongwe
50,42,2022-12-12,183,17,460,49,Lilongwe
51,43,2022-12-19,224,22,684,71,Lilongwe
52,44,2022-12-26,511,33,1195,104,Lilongwe
1,45,2023-01-02,574,36,1769,140,Lilongwe
2,46,2023-01-09,770,39,2539,179,Lilongwe
3,47,2023-01-16,927,54,3466,233,Lilongwe
4,48,2023-01-23,1198,57,4664,290,Lilongwe
5,49,2023-01-30,1338,76,6002,366,Lilongwe
6,50,2023-02-06,1089,53,7091,419,Lilongwe
7,51,2023-02-13,1197,34,8288,453,Lilongwe
8,52,2023-02-20,1030,33,9318,486,Lilongwe
9,53,2023-02-27,891,25,10209,511,Lilongwe
10,54,2023-03-06,761,15,10970,526,Lilongwe
11,55,2023-03-13,627,12,11597,538,Lilongwe
12,56,2023-03-20,391,8,11988,546,Lilongwe
13,57,2023-03-27,244,3,12232,549,Lilongwe
14,58,2023-04-03,188,4,12420,553,Lilongwe
15,59,2023-04-10,147,5,12567,558,Lilongwe
16,60,2023-04-17,51,0,12618,558,Lilongwe
17,61,2023-04-24,42,0,12660,558,Lilongwe
18,62,2023-05-01,14,0,12674,558,Lilongwe
19,63,2023-05-08,8,0,12682,558,Lilongwe
20,64,2023-05-15,3,0,12685,558,Lilongwe
21,65,2023-05-22,6,1,12691,559,Lilongwe
22,66,2023-05-29,1,0,12692,559,Lilongwe
23,67,2023-06-05,0,0,12692,559,Lilongwe
24,68,2023-06-12,0,0,12692,559,Lilongwe
25,69,2023-06-19,0,0,12692,559,Lilongwe
26,70,2023-06-26,0,0,12692,559,Lilongwe
27,71,2023-07-03,0,0,12692,559,Lilongwe
28,72,2023-07-10,0,0,12692,559,Lilongwe
29,73,2023-07-17,0,0,12692,559,Lilongwe
30,74,2023-07-24,0,0,12692,559,Lilongwe
31,75,2023-07-31,0,0,12692,559,Lilongwe
32,76,2023-08-07,0,0,12692,559,Lilongwe
33,77,2023-08-14,0,0,12692,559,Lilongwe
34,78,2023-08-21,0,0,12692,559,Lilongwe
35,79,2023-08-28,0,0,12692,559,Lilongwe
36,80,2023-09-04,0,0,12692,559,Lilongwe
37,81,2023-09-11,1,0,12693,559,Lilongwe
38,82,2023-09-18,1,0,12694,559,Lilongwe
39,83,2023-09-25,10,0,12704,559,Lilongwe
40,84,2023-10-02,0,0,12704,559,Lilongwe
41,85,2023-10-09,1,0,12705,559,Lilongwe
42,86,2023-10-16,2,0,12707,559,Lilongwe
43,87,2023-10-23,0,0,12707,559,Lilongwe
9,1,2022-02-28,1,0,1,0,Machinga
10,2,2022-03-07,0,0,1,0,Machinga
11,3,2022-03-14,0,0,1,0,Machinga
12,4,2022-03-21,0,0,1,0,Machinga
13,5,2022-03-28,1,0,2,0,Machinga
14,6,2022-04-04,0,0,2,0,Machinga
15,7,2022-04-11,0,0,2,0,Machinga
16,8,2022-04-18,0,0,2,0,Machinga
17,9,2022-04-25,0,0,2,0,Machinga
18,10,2022-05-02,0,0,2,0,Machinga
19,11,2022-05-09,0,0,2,0,Machinga
20,12,2022-05-16,0,0,2,0,Machinga
21,13,2022-05-23,10,2,12,2,Machinga
22,14,2022-05-30,0,0,12,2,Machinga
23,15,2022-06-06,0,0,12,2,Machinga
24,16,2022-06-13,0,0,12,2,Machinga
25,17,2022-06-20,0,0,12,2,Machinga
26,18,2022-06-27,0,0,12,2,Machinga
27,19,2022-07-04,0,0,12,2,Machinga
28,20,2022-07-11,1,0,13,2,Machinga
29,21,2022-07-18,3,0,16,2,Machinga
30,22,2022-07-25,0,0,16,2,Machinga
31,23,2022-08-01,0,0,16,2,Machinga
32,24,2022-08-08,0,0,16,2,Machinga
33,25,2022-08-15,0,0,16,2,Machinga
34,26,2022-08-22,5,2,21,4,Machinga
35,27,2022-08-29,1,0,22,4,Machinga
36,28,2022-09-05,0,0,22,4,Machinga
37,29,2022-09-12,0,0,22,4,Machinga
38,30,2022-09-19,0,0,22,4,Machinga
39,31,2022-09-26,1,0,23,4,Machinga
40,32,2022-10-03,1,0,24,4,Machinga
41,33,2022-10-10,5,1,29,5,Machinga
42,34,2022-10-17,1,0,30,5,Machinga
43,35,2022-10-24,6,0,36,5,Machinga
44,36,2022-10-31,5,0,41,5,Machinga
45,37,2022-11-07,6,1,47,6,Machinga
46,38,2022-11-14,10,0,57,6,Machinga
47,39,2022-11-21,10,0,67,6,Machinga
48,40,2022-11-28,20,1,87,7,Machinga
49,41,2022-12-05,16,0,103,7,Machinga
50,42,2022-12-12,21,0,124,7,Machinga
51,43,2022-12-19,59,7,183,14,Machinga
52,44,2022-12-26,239,13,422,27,Machinga
1,45,2023-01-02,382,8,804,35,Machinga
2,46,2023-01-09,302,10,1106,45,Machinga
3,47,2023-01-16,266,6,1372,51,Machinga
4,48,2023-01-23,238,13,1610,64,Machinga
5,49,2023-01-30,283,12,1893,76,Machinga
6,50,2023-02-06,205,15,2098,91,Machinga
7,51,2023-02-13,182,4,2280,95,Machinga
8,52,2023-02-20,116,3,2396,98,Machinga
9,53,2023-02-27,93,4,2489,102,Machinga
10,54,2023-03-06,65,1,2554,103,Machinga
11,55,2023-03-13,34,0,2588,103,Machinga
12,56,2023-03-20,27,0,2615,103,Machinga
13,57,2023-03-27,29,0,2644,103,Machinga
14,58,2023-04-03,15,1,2659,104,Machinga
15,59,2023-04-10,18,0,2677,104,Machinga
16,60,2023-04-17,6,0,2683,104,Machinga
17,61,2023-04-24,10,0,2693,104,Machinga
18,62,2023-05-01,10,0,2703,104,Machinga
19,63,2023-05-08,3,0,2706,104,Machinga
20,64,2023-05-15,5,0,2711,104,Machinga
21,65,2023-05-22,1,0,2712,104,Machinga
22,66,2023-05-29,1,0,2713,104,Machinga
23,67,2023-06-05,0,0,2713,104,Machinga
24,68,2023-06-12,6,0,2719,104,Machinga
25,69,2023-06-19,0,0,2719,104,Machinga
26,70,2023-06-26,0,0,2719,104,Machinga
27,71,2023-07-03,0,0,2719,104,Machinga
28,72,2023-07-10,0,0,2719,104,Machinga
29,73,2023-07-17,0,0,2719,104,Machinga
30,74,2023-07-24,0,0,2719,104,Machinga
31,75,2023-07-31,0,0,2719,104,Machinga
32,76,2023-08-07,0,0,2719,104,Machinga
33,77,2023-08-14,0,0,2719,104,Machinga
34,78,2023-08-21,0,0,2719,104,Machinga
35,79,2023-08-28,0,0,2719,104,Machinga
36,80,2023-09-04,0,0,2719,104,Machinga
37,81,2023-09-11,0,0,2719,104,Machinga
38,82,2023-09-18,0,0,2719,104,Machinga
39,83,2023-09-25,0,0,2719,104,Machinga
40,84,2023-10-02,0,0,2719,104,Machinga
41,85,2023-10-09,0,0,2719,104,Machinga
42,86,2023-10-16,0,0,2719,104,Machinga
43,87,2023-10-23,0,0,2719,104,Machinga
25,17,2022-06-20,1,0,1,1,Mangochi
26,18,2022-06-27,0,0,1,1,Mangochi
27,19,2022-07-04,0,0,1,1,Mangochi
28,20,2022-07-11,0,0,1,1,Mangochi
29,21,2022-07-18,0,0,1,1,Mangochi
30,22,2022-07-25,0,0,1,1,Mangochi
31,23,2022-08-01,0,0,1,1,Mangochi
32,24,2022-08-08,0,0,1,1,Mangochi
33,25,2022-08-15,0,0,1,1,Mangochi
34,26,2022-08-22,0,0,1,1,Mangochi
35,27,2022-08-29,0,0,1,1,Mangochi
36,28,2022-09-05,0,0,1,1,Mangochi
37,29,2022-09-12,0,0,1,1,Mangochi
38,30,2022-09-19,0,0,1,1,Mangochi
39,31,2022-09-26,5,1,6,2,Mangochi
40,32,2022-10-03,10,0,16,2,Mangochi
41,33,2022-10-10,16,1,32,3,Mangochi
42,34,2022-10-17,17,0,49,3,Mangochi
43,35,2022-10-24,125,4,174,7,Mangochi
44,36,2022-10-31,296,7,470,14,Mangochi
45,37,2022-11-07,325,11,795,25,Mangochi
46,38,2022-11-14,238,4,1033,29,Mangochi
47,39,2022-11-21,696,8,1729,37,Mangochi
48,40,2022-11-28,481,10,2210,47,Mangochi
49,41,2022-12-05,622,6,2832,53,Mangochi
50,42,2022-12-12,419,14,3251,67,Mangochi
51,43,2022-12-19,330,7,3581,74,Mangochi
52,44,2022-12-26,369,8,3950,82,Mangochi
1,45,2023-01-02,518,7,4468,89,Mangochi
2,46,2023-01-09,531,1,4999,90,Mangochi
3,47,2023-01-16,642,3,5641,93,Mangochi
4,48,2023-01-23,636,14,6277,107,Mangochi
5,49,2023-01-30,518,5,6795,112,Mangochi
6,50,2023-02-06,465,6,7260,118,Mangochi
7,51,2023-02-13,300,1,7560,119,Mangochi
8,52,2023-02-20,261,0,7821,119,Mangochi
9,53,2023-02-27,117,1,7938,120,Mangochi
10,54,2023-03-06,78,0,8016,120,Mangochi
11,55,2023-03-13,46,0,8062,120,Mangochi
12,56,2023-03-20,44,0,8106,120,Mangochi
13,57,2023-03-27,21,0,8127,120,Mangochi
14,58,2023-04-03,20,1,8147,121,Mangochi
15,59,2023-04-10,25,0,8172,121,Mangochi
16,60,2023-04-17,7,0,8179,121,Mangochi
17,61,2023-04-24,2,0,8181,121,Mangochi
18,62,2023-05-01,1,0,8182,121,Mangochi
19,63,2023-05-08,0,0,8182,121,Mangochi
20,64,2023-05-15,0,0,8182,121,Mangochi
21,65,2023-05-22,0,0,8182,121,Mangochi
22,66,2023-05-29,0,0,8182,121,Mangochi
23,67,2023-06-05,0,0,8182,121,Mangochi
24,68,2023-06-12,0,0,8182,121,Mangochi
25,69,2023-06-19,0,0,8182,121,Mangochi
26,70,2023-06-26,0,0,8182,121,Mangochi
27,71,2023-07-03,1,0,8183,121,Mangochi
28,72,2023-07-10,0,0,8183,121,Mangochi
29,73,2023-07-17,0,0,8183,121,Mangochi
30,74,2023-07-24,5,0,8188,121,Mangochi
31,75,2023-07-31,6,0,8194,121,Mangochi
32,76,2023-08-07,0,0,8194,121,Mangochi
33,77,2023-08-14,0,0,8194,121,Mangochi
34,78,2023-08-21,0,0,8194,121,Mangochi
35,79,2023-08-28,0,0,8194,121,Mangochi
36,80,2023-09-04,0,0,8194,121,Mangochi
37,81,2023-09-11,0,0,8194,121,Mangochi
38,82,2023-09-18,0,0,8194,121,Mangochi
39,83,2023-09-25,0,0,8194,121,Mangochi
40,84,2023-10-02,0,0,8194,121,Mangochi
41,85,2023-10-09,0,0,8194,121,Mangochi
42,86,2023-10-16,0,0,8194,121,Mangochi
43,87,2023-10-23,0,0,8194,121,Mangochi
44,36,2022-10-31,2,0,2,0,Mchinji
45,37,2022-11-07,1,0,3,0,Mchinji
46,38,2022-11-14,0,0,3,0,Mchinji
47,39,2022-11-21,5,0,8,0,Mchinji
48,40,2022-11-28,10,1,18,1,Mchinji
49,41,2022-12-05,0,0,18,1,Mchinji
50,42,2022-12-12,0,0,18,1,Mchinji
51,43,2022-12-19,0,0,18,1,Mchinji
52,44,2022-12-26,1,0,19,1,Mchinji
1,45,2023-01-02,1,0,20,1,Mchinji
2,46,2023-01-09,17,0,37,1,Mchinji
3,47,2023-01-16,1,0,38,1,Mchinji
4,48,2023-01-23,6,0,44,1,Mchinji
5,49,2023-01-30,13,1,57,2,Mchinji
6,50,2023-02-06,27,1,84,3,Mchinji
7,51,2023-02-13,21,2,105,5,Mchinji
8,52,2023-02-20,30,3,135,8,Mchinji
9,53,2023-02-27,42,2,177,10,Mchinji
10,54,2023-03-06,35,2,212,12,Mchinji
11,55,2023-03-13,40,2,252,14,Mchinji
12,56,2023-03-20,42,0,294,14,Mchinji
13,57,2023-03-27,65,2,359,16,Mchinji
14,58,2023-04-03,23,0,382,16,Mchinji
15,59,2023-04-10,6,0,388,16,Mchinji
16,60,2023-04-17,1,0,389,16,Mchinji
17,61,2023-04-24,0,0,389,16,Mchinji
18,62,2023-05-01,5,0,394,16,Mchinji
19,63,2023-05-08,2,0,396,16,Mchinji
20,64,2023-05-15,0,0,396,16,Mchinji
21,65,2023-05-22,1,0,397,16,Mchinji
22,66,2023-05-29,0,0,397,16,Mchinji
23,67,2023-06-05,0,0,397,16,Mchinji
24,68,2023-06-12,0,0,397,16,Mchinji
25,69,2023-06-19,0,0,397,16,Mchinji
26,70,2023-06-26,0,0,397,16,Mchinji
27,71,2023-07-03,0,0,397,16,Mchinji
28,72,2023-07-10,0,0,397,16,Mchinji
29,73,2023-07-17,0,0,397,16,Mchinji
30,74,2023-07-24,0,0,397,16,Mchinji
31,75,2023-07-31,0,0,397,16,Mchinji
32,76,2023-08-07,0,0,397,16,Mchinji
33,77,2023-08-14,0,0,397,16,Mchinji
34,78,2023-08-21,0,0,397,16,Mchinji
35,79,2023-08-28,0,0,397,16,Mchinji
36,80,2023-09-04,0,0,397,16,Mchinji
37,81,2023-09-11,0,0,397,16,Mchinji
38,82,2023-09-18,0,0,397,16,Mchinji
39,83,2023-09-25,0,0,397,16,Mchinji
40,84,2023-10-02,0,0,397,16,Mchinji
41,85,2023-10-09,0,0,397,16,Mchinji
42,86,2023-10-16,0,0,397,16,Mchinji
43,87,2023-10-23,1,0,398,16,Mchinji
19,11,2022-05-09,1,1,1,1,Mulanje
20,12,2022-05-16,0,0,1,1,Mulanje
21,13,2022-05-23,0,0,1,1,Mulanje
22,14,2022-05-30,0,0,1,1,Mulanje
23,15,2022-06-06,0,0,1,1,Mulanje
24,16,2022-06-13,0,0,1,1,Mulanje
25,17,2022-06-20,0,0,1,1,Mulanje
26,18,2022-06-27,0,0,1,1,Mulanje
27,19,2022-07-04,1,1,2,2,Mulanje
28,20,2022-07-11,1,0,3,2,Mulanje
29,21,2022-07-18,0,0,3,2,Mulanje
30,22,2022-07-25,0,0,3,2,Mulanje
31,23,2022-08-01,0,0,3,2,Mulanje
32,24,2022-08-08,0,0,3,2,Mulanje
33,25,2022-08-15,0,0,3,2,Mulanje
34,26,2022-08-22,0,0,3,2,Mulanje
35,27,2022-08-29,0,0,3,2,Mulanje
36,28,2022-09-05,2,0,5,2,Mulanje
37,29,2022-09-12,1,0,6,2,Mulanje
38,30,2022-09-19,0,0,6,2,Mulanje
39,31,2022-09-26,0,0,6,2,Mulanje
40,32,2022-10-03,0,0,6,2,Mulanje
41,33,2022-10-10,8,0,14,2,Mulanje
42,34,2022-10-17,17,1,31,3,Mulanje
43,35,2022-10-24,10,1,41,4,Mulanje
44,36,2022-10-31,2,1,43,5,Mulanje
45,37,2022-11-07,0,0,43,5,Mulanje
46,38,2022-11-14,1,0,44,5,Mulanje
47,39,2022-11-21,1,0,45,5,Mulanje
48,40,2022-11-28,9,0,54,5,Mulanje
49,41,2022-12-05,4,0,58,5,Mulanje
50,42,2022-12-12,7,0,65,5,Mulanje
51,43,2022-12-19,7,0,72,5,Mulanje
52,44,2022-12-26,52,3,124,8,Mulanje
1,45,2023-01-02,61,1,185,9,Mulanje
2,46,2023-01-09,87,4,272,13,Mulanje
3,47,2023-01-16,144,9,416,22,Mulanje
4,48,2023-01-23,108,4,524,26,Mulanje
5,49,2023-01-30,70,1,594,27,Mulanje
6,50,2023-02-06,65,1,659,28,Mulanje
7,51,2023-02-13,46,2,705,30,Mulanje
8,52,2023-02-20,58,2,763,32,Mulanje
9,53,2023-02-27,43,0,806,32,Mulanje
10,54,2023-03-06,14,0,820,32,Mulanje
11,55,2023-03-13,37,3,857,35,Mulanje
12,56,2023-03-20,34,5,891,40,Mulanje
13,57,2023-03-27,6,0,897,40,Mulanje
14,58,2023-04-03,3,0,900,40,Mulanje
15,59,2023-04-10,7,0,907,40,Mulanje
16,60,2023-04-17,4,0,911,40,Mulanje
17,61,2023-04-24,9,0,920,40,Mulanje
18,62,2023-05-01,10,1,930,41,Mulanje
19,63,2023-05-08,5,1,935,42,Mulanje
20,64,2023-05-15,1,0,936,42,Mulanje
21,65,2023-05-22,0,0,936,42,Mulanje
22,66,2023-05-29,1,0,937,42,Mulanje
23,67,2023-06-05,0,0,937,42,Mulanje
24,68,2023-06-12,0,0,937,42,Mulanje
25,69,2023-06-19,0,0,937,42,Mulanje
26,70,2023-06-26,0,0,937,42,Mulanje
27,71,2023-07-03,1,0,938,42,Mulanje
28,72,2023-07-10,0,0,938,42,Mulanje
29,73,2023-07-17,0,0,938,42,Mulanje
30,74,2023-07-24,0,0,938,42,Mulanje
31,75,2023-07-31,0,0,938,42,Mulanje
32,76,2023-08-07,0,0,938,42,Mulanje
33,77,2023-08-14,1,0,939,42,Mulanje
34,78,2023-08-21,0,0,939,42,Mulanje
35,79,2023-08-28,1,0,940,42,Mulanje
36,80,2023-09-04,0,0,940,42,Mulanje
37,81,2023-09-11,0,0,940,42,Mulanje
38,82,2023-09-18,1,0,941,42,Mulanje
39,83,2023-09-25,1,0,942,42,Mulanje
40,84,2023-10-02,0,0,942,42,Mulanje
41,85,2023-10-09,3,0,945,42,Mulanje
42,86,2023-10-16,1,1,946,43,Mulanje
43,87,2023-10-23,0,0,946,43,Mulanje
35,27,2022-08-29,1,0,1,0,Mwanza
36,28,2022-09-05,2,0,3,0,Mwanza
37,29,2022-09-12,5,0,8,0,Mwanza
38,30,2022-09-19,1,0,9,0,Mwanza
39,31,2022-09-26,4,1,13,1,Mwanza
40,32,2022-10-03,2,0,15,1,Mwanza
41,33,2022-10-10,1,0,16,1,Mwanza
42,34,2022-10-17,4,0,20,1,Mwanza
43,35,2022-10-24,4,1,24,2,Mwanza
44,36,2022-10-31,2,0,26,2,Mwanza
45,37,2022-11-07,4,0,30,2,Mwanza
46,38,2022-11-14,0,0,30,2,Mwanza
47,39,2022-11-21,0,0,30,2,Mwanza
48,40,2022-11-28,0,0,30,2,Mwanza
49,41,2022-12-05,0,0,30,2,Mwanza
50,42,2022-12-12,0,0,30,2,Mwanza
51,43,2022-12-19,4,0,34,2,Mwanza
52,44,2022-12-26,8,1,42,3,Mwanza
1,45,2023-01-02,1,0,43,3,Mwanza
2,46,2023-01-09,1,0,44,3,Mwanza
3,47,2023-01-16,4,1,48,4,Mwanza
4,48,2023-01-23,1,0,49,4,Mwanza
5,49,2023-01-30,5,0,54,4,Mwanza
6,50,2023-02-06,7,0,61,4,Mwanza
7,51,2023-02-13,9,0,70,4,Mwanza
8,52,2023-02-20,11,0,81,4,Mwanza
9,53,2023-02-27,7,1,88,5,Mwanza
10,54,2023-03-06,21,0,109,5,Mwanza
11,55,2023-03-13,4,0,113,5,Mwanza
12,56,2023-03-20,7,0,120,5,Mwanza
13,57,2023-03-27,0,0,120,5,Mwanza
14,58,2023-04-03,0,0,120,5,Mwanza
15,59,2023-04-10,0,0,120,5,Mwanza
16,60,2023-04-17,0,0,120,5,Mwanza
17,61,2023-04-24,0,0,120,5,Mwanza
18,62,2023-05-01,0,0,120,5,Mwanza
19,63,2023-05-08,0,0,120,5,Mwanza
20,64,2023-05-15,0,0,120,5,Mwanza
21,65,2023-05-22,0,0,120,5,Mwanza
22,66,2023-05-29,0,0,120,5,Mwanza
23,67,2023-06-05,0,0,120,5,Mwanza
24,68,2023-06-12,0,0,120,5,Mwanza
25,69,2023-06-19,0,0,120,5,Mwanza
26,70,2023-06-26,0,0,120,5,Mwanza
27,71,2023-07-03,0,0,120,5,Mwanza
28,72,2023-07-10,0,0,120,5,Mwanza
29,73,2023-07-17,0,0,120,5,Mwanza
30,74,2023-07-24,0,0,120,5,Mwanza
31,75,2023-07-31,0,0,120,5,Mwanza
32,76,2023-08-07,0,0,120,5,Mwanza
33,77,2023-08-14,0,0,120,5,Mwanza
34,78,2023-08-21,0,0,120,5,Mwanza
35,79,2023-08-28,0,0,120,5,Mwanza
36,80,2023-09-04,0,0,120,5,Mwanza
37,81,2023-09-11,0,0,120,5,Mwanza
38,82,2023-09-18,0,0,120,5,Mwanza
39,83,2023-09-25,0,0,120,5,Mwanza
40,84,2023-10-02,0,0,120,5,Mwanza
41,85,2023-10-09,0,0,120,5,Mwanza
42,86,2023-10-16,0,0,120,5,Mwanza
43,87,2023-10-23,0,0,120,5,Mwanza
34,26,2022-08-22,1,0,1,0,Mzimba.North
35,27,2022-08-29,40,0,41,0,Mzimba.North
36,28,2022-09-05,223,1,264,1,Mzimba.North
37,29,2022-09-12,37,0,301,1,Mzimba.North
38,30,2022-09-19,32,0,333,1,Mzimba.North
39,31,2022-09-26,48,0,381,1,Mzimba.North
40,32,2022-10-03,22,0,403,1,Mzimba.North
41,33,2022-10-10,6,1,409,2,Mzimba.North
42,34,2022-10-17,14,0,423,2,Mzimba.North
43,35,2022-10-24,0,0,423,2,Mzimba.North
44,36,2022-10-31,0,0,423,2,Mzimba.North
45,37,2022-11-07,28,0,451,2,Mzimba.North
46,38,2022-11-14,7,0,458,2,Mzimba.North
47,39,2022-11-21,1,0,459,2,Mzimba.North
48,40,2022-11-28,4,0,463,2,Mzimba.North
49,41,2022-12-05,0,0,463,2,Mzimba.North
50,42,2022-12-12,2,0,465,2,Mzimba.North
51,43,2022-12-19,0,0,465,2,Mzimba.North
52,44,2022-12-26,0,0,465,2,Mzimba.North
1,45,2023-01-02,0,0,465,2,Mzimba.North
2,46,2023-01-09,0,0,465,2,Mzimba.North
3,47,2023-01-16,3,0,468,2,Mzimba.North
4,48,2023-01-23,2,0,470,2,Mzimba.North
5,49,2023-01-30,2,0,472,2,Mzimba.North
6,50,2023-02-06,NA,NA,472,2,Mzimba.North
7,51,2023-02-13,0,0,472,2,Mzimba.North
8,52,2023-02-20,0,0,472,2,Mzimba.North
9,53,2023-02-27,1,0,473,2,Mzimba.North
10,54,2023-03-06,0,0,473,2,Mzimba.North
11,55,2023-03-13,0,0,473,2,Mzimba.North
12,56,2023-03-20,2,0,475,2,Mzimba.North
13,57,2023-03-27,0,0,475,2,Mzimba.North
14,58,2023-04-03,0,0,475,2,Mzimba.North
15,59,2023-04-10,0,0,475,2,Mzimba.North
16,60,2023-04-17,0,0,475,2,Mzimba.North
17,61,2023-04-24,0,0,475,2,Mzimba.North
18,62,2023-05-01,0,0,475,2,Mzimba.North
19,63,2023-05-08,0,0,475,2,Mzimba.North
20,64,2023-05-15,0,0,475,2,Mzimba.North
21,65,2023-05-22,0,0,475,2,Mzimba.North
22,66,2023-05-29,0,0,475,2,Mzimba.North
23,67,2023-06-05,0,0,475,2,Mzimba.North
24,68,2023-06-12,0,0,475,2,Mzimba.North
25,69,2023-06-19,0,0,475,2,Mzimba.North
26,70,2023-06-26,0,0,475,2,Mzimba.North
27,71,2023-07-03,0,0,475,2,Mzimba.North
28,72,2023-07-10,0,0,475,2,Mzimba.North
29,73,2023-07-17,0,0,475,2,Mzimba.North
30,74,2023-07-24,0,0,475,2,Mzimba.North
31,75,2023-07-31,0,0,475,2,Mzimba.North
32,76,2023-08-07,0,0,475,2,Mzimba.North
33,77,2023-08-14,0,0,475,2,Mzimba.North
34,78,2023-08-21,0,0,475,2,Mzimba.North
35,79,2023-08-28,0,0,475,2,Mzimba.North
36,80,2023-09-04,0,0,475,2,Mzimba.North
37,81,2023-09-11,0,0,475,2,Mzimba.North
38,82,2023-09-18,0,0,475,2,Mzimba.North
39,83,2023-09-25,0,0,475,2,Mzimba.North
40,84,2023-10-02,0,0,475,2,Mzimba.North
41,85,2023-10-09,0,0,475,2,Mzimba.North
42,86,2023-10-16,0,0,475,2,Mzimba.North
43,87,2023-10-23,0,0,475,2,Mzimba.North
36,28,2022-09-05,4,0,4,0,Mzimba.South
37,29,2022-09-12,2,1,6,1,Mzimba.South
38,30,2022-09-19,1,0,7,1,Mzimba.South
39,31,2022-09-26,0,0,7,1,Mzimba.South
40,32,2022-10-03,0,0,7,1,Mzimba.South
41,33,2022-10-10,0,0,7,1,Mzimba.South
42,34,2022-10-17,0,0,7,1,Mzimba.South
43,35,2022-10-24,0,0,7,1,Mzimba.South
44,36,2022-10-31,0,0,7,1,Mzimba.South
45,37,2022-11-07,0,0,7,1,Mzimba.South
46,38,2022-11-14,0,0,7,1,Mzimba.South
47,39,2022-11-21,0,0,7,1,Mzimba.South
48,40,2022-11-28,0,0,7,1,Mzimba.South
49,41,2022-12-05,0,0,7,1,Mzimba.South
50,42,2022-12-12,0,0,7,1,Mzimba.South
51,43,2022-12-19,0,0,7,1,Mzimba.South
52,44,2022-12-26,0,0,7,1,Mzimba.South
1,45,2023-01-02,0,0,7,1,Mzimba.South
2,46,2023-01-09,0,0,7,1,Mzimba.South
3,47,2023-01-16,0,0,7,1,Mzimba.South
4,48,2023-01-23,0,0,7,1,Mzimba.South
5,49,2023-01-30,0,0,7,1,Mzimba.South
6,50,2023-02-06,0,0,7,1,Mzimba.South
7,51,2023-02-13,4,0,11,1,Mzimba.South
8,52,2023-02-20,0,0,11,1,Mzimba.South
9,53,2023-02-27,0,0,11,1,Mzimba.South
10,54,2023-03-06,0,0,11,1,Mzimba.South
11,55,2023-03-13,0,0,11,1,Mzimba.South
12,56,2023-03-20,0,0,11,1,Mzimba.South
13,57,2023-03-27,0,0,11,1,Mzimba.South
14,58,2023-04-03,0,0,11,1,Mzimba.South
15,59,2023-04-10,0,0,11,1,Mzimba.South
16,60,2023-04-17,0,0,11,1,Mzimba.South
17,61,2023-04-24,0,0,11,1,Mzimba.South
18,62,2023-05-01,0,0,11,1,Mzimba.South
19,63,2023-05-08,0,0,11,1,Mzimba.South
20,64,2023-05-15,0,0,11,1,Mzimba.South
21,65,2023-05-22,0,0,11,1,Mzimba.South
22,66,2023-05-29,0,0,11,1,Mzimba.South
23,67,2023-06-05,0,0,11,1,Mzimba.South
24,68,2023-06-12,0,0,11,1,Mzimba.South
25,69,2023-06-19,0,0,11,1,Mzimba.South
26,70,2023-06-26,0,0,11,1,Mzimba.South
27,71,2023-07-03,0,0,11,1,Mzimba.South
28,72,2023-07-10,0,0,11,1,Mzimba.South
29,73,2023-07-17,0,0,11,1,Mzimba.South
30,74,2023-07-24,0,0,11,1,Mzimba.South
31,75,2023-07-31,0,0,11,1,Mzimba.South
32,76,2023-08-07,0,0,11,1,Mzimba.South
33,77,2023-08-14,0,0,11,1,Mzimba.South
34,78,2023-08-21,0,0,11,1,Mzimba.South
35,79,2023-08-28,0,0,11,1,Mzimba.South
36,80,2023-09-04,0,0,11,1,Mzimba.South
37,81,2023-09-11,0,0,11,1,Mzimba.South
38,82,2023-09-18,0,0,11,1,Mzimba.South
39,83,2023-09-25,0,0,11,1,Mzimba.South
40,84,2023-10-02,0,0,11,1,Mzimba.South
41,85,2023-10-09,0,0,11,1,Mzimba.South
42,86,2023-10-16,0,0,11,1,Mzimba.South
43,87,2023-10-23,0,0,11,1,Mzimba.South
17,9,2022-04-25,15,0,15,0,Neno
18,10,2022-05-02,13,0,28,0,Neno
19,11,2022-05-09,22,1,50,1,Neno
20,12,2022-05-16,23,0,73,1,Neno
21,13,2022-05-23,16,0,89,1,Neno
22,14,2022-05-30,3,0,92,1,Neno
23,15,2022-06-06,7,1,99,2,Neno
24,16,2022-06-13,6,0,105,2,Neno
25,17,2022-06-20,7,0,112,2,Neno
26,18,2022-06-27,6,0,118,2,Neno
27,19,2022-07-04,1,0,119,2,Neno
28,20,2022-07-11,4,0,123,2,Neno
29,21,2022-07-18,1,0,124,2,Neno
30,22,2022-07-25,2,0,126,2,Neno
31,23,2022-08-01,0,0,126,2,Neno
32,24,2022-08-08,0,0,126,2,Neno
33,25,2022-08-15,0,0,126,2,Neno
34,26,2022-08-22,0,0,126,2,Neno
35,27,2022-08-29,0,0,126,2,Neno
36,28,2022-09-05,1,0,127,2,Neno
37,29,2022-09-12,1,0,128,2,Neno
38,30,2022-09-19,5,0,133,2,Neno
39,31,2022-09-26,7,0,140,2,Neno
40,32,2022-10-03,4,1,144,3,Neno
41,33,2022-10-10,21,0,165,3,Neno
42,34,2022-10-17,10,1,175,4,Neno
43,35,2022-10-24,6,0,181,4,Neno
44,36,2022-10-31,6,0,187,4,Neno
45,37,2022-11-07,3,0,190,4,Neno
46,38,2022-11-14,0,0,190,4,Neno
47,39,2022-11-21,1,0,191,4,Neno
48,40,2022-11-28,0,0,191,4,Neno
49,41,2022-12-05,0,0,191,4,Neno
50,42,2022-12-12,0,0,191,4,Neno
51,43,2022-12-19,3,3,194,7,Neno
52,44,2022-12-26,9,0,203,7,Neno
1,45,2023-01-02,31,1,234,8,Neno
2,46,2023-01-09,41,1,275,9,Neno
3,47,2023-01-16,44,0,319,9,Neno
4,48,2023-01-23,50,1,369,10,Neno
5,49,2023-01-30,72,3,441,13,Neno
6,50,2023-02-06,77,0,518,13,Neno
7,51,2023-02-13,35,1,553,14,Neno
8,52,2023-02-20,37,0,590,14,Neno
9,53,2023-02-27,23,0,613,14,Neno
10,54,2023-03-06,23,0,636,14,Neno
11,55,2023-03-13,1,0,637,14,Neno
12,56,2023-03-20,16,0,653,14,Neno
13,57,2023-03-27,12,0,665,14,Neno
14,58,2023-04-03,48,0,713,14,Neno
15,59,2023-04-10,8,0,721,14,Neno
16,60,2023-04-17,4,0,725,14,Neno
17,61,2023-04-24,7,0,732,14,Neno
18,62,2023-05-01,0,0,732,14,Neno
19,63,2023-05-08,1,0,733,14,Neno
20,64,2023-05-15,0,0,733,14,Neno
21,65,2023-05-22,0,0,733,14,Neno
22,66,2023-05-29,0,0,733,14,Neno
23,67,2023-06-05,0,0,733,14,Neno
24,68,2023-06-12,0,0,733,14,Neno
25,69,2023-06-19,1,0,734,14,Neno
26,70,2023-06-26,0,0,734,14,Neno
27,71,2023-07-03,0,0,734,14,Neno
28,72,2023-07-10,0,0,734,14,Neno
29,73,2023-07-17,0,0,734,14,Neno
30,74,2023-07-24,0,0,734,14,Neno
31,75,2023-07-31,0,0,734,14,Neno
32,76,2023-08-07,0,0,734,14,Neno
33,77,2023-08-14,0,0,734,14,Neno
34,78,2023-08-21,0,0,734,14,Neno
35,79,2023-08-28,0,0,734,14,Neno
36,80,2023-09-04,0,0,734,14,Neno
37,81,2023-09-11,0,0,734,14,Neno
38,82,2023-09-18,0,0,734,14,Neno
39,83,2023-09-25,0,0,734,14,Neno
40,84,2023-10-02,0,0,734,14,Neno
41,85,2023-10-09,0,0,734,14,Neno
42,86,2023-10-16,0,0,734,14,Neno
43,87,2023-10-23,0,0,734,14,Neno
31,23,2022-08-01,2,2,2,2,Nkhatabay
32,24,2022-08-08,59,3,61,5,Nkhatabay
33,25,2022-08-15,315,5,376,10,Nkhatabay
34,26,2022-08-22,144,3,520,13,Nkhatabay
35,27,2022-08-29,99,2,619,15,Nkhatabay
36,28,2022-09-05,42,0,661,15,Nkhatabay
37,29,2022-09-12,40,0,701,15,Nkhatabay
38,30,2022-09-19,50,2,751,17,Nkhatabay
39,31,2022-09-26,107,4,858,21,Nkhatabay
40,32,2022-10-03,107,3,965,24,Nkhatabay
41,33,2022-10-10,95,3,1060,27,Nkhatabay
42,34,2022-10-17,59,4,1119,31,Nkhatabay
43,35,2022-10-24,55,3,1174,34,Nkhatabay
44,36,2022-10-31,138,5,1312,39,Nkhatabay
45,37,2022-11-07,80,3,1392,42,Nkhatabay
46,38,2022-11-14,92,2,1484,44,Nkhatabay
47,39,2022-11-21,58,2,1542,46,Nkhatabay
48,40,2022-11-28,30,2,1572,48,Nkhatabay
49,41,2022-12-05,14,0,1586,48,Nkhatabay
50,42,2022-12-12,9,0,1595,48,Nkhatabay
51,43,2022-12-19,4,1,1599,49,Nkhatabay
52,44,2022-12-26,10,0,1609,49,Nkhatabay
1,45,2023-01-02,4,0,1613,49,Nkhatabay
2,46,2023-01-09,11,0,1624,49,Nkhatabay
3,47,2023-01-16,1,0,1625,49,Nkhatabay
4,48,2023-01-23,NA,NA,1625,49,Nkhatabay
5,49,2023-01-30,NA,NA,1625,49,Nkhatabay
6,50,2023-02-06,2,0,1627,49,Nkhatabay
7,51,2023-02-13,1,0,1628,49,Nkhatabay
8,52,2023-02-20,0,0,1628,49,Nkhatabay
9,53,2023-02-27,0,0,1628,49,Nkhatabay
10,54,2023-03-06,0,0,1628,49,Nkhatabay
11,55,2023-03-13,0,0,1628,49,Nkhatabay
12,56,2023-03-20,0,0,1628,49,Nkhatabay
13,57,2023-03-27,0,0,1628,49,Nkhatabay
14,58,2023-04-03,0,0,1628,49,Nkhatabay
15,59,2023-04-10,0,0,1628,49,Nkhatabay
16,60,2023-04-17,0,0,1628,49,Nkhatabay
17,61,2023-04-24,0,0,1628,49,Nkhatabay
18,62,2023-05-01,0,0,1628,49,Nkhatabay
19,63,2023-05-08,0,0,1628,49,Nkhatabay
20,64,2023-05-15,0,0,1628,49,Nkhatabay
21,65,2023-05-22,0,0,1628,49,Nkhatabay
22,66,2023-05-29,0,0,1628,49,Nkhatabay
23,67,2023-06-05,0,0,1628,49,Nkhatabay
24,68,2023-06-12,0,0,1628,49,Nkhatabay
25,69,2023-06-19,0,0,1628,49,Nkhatabay
26,70,2023-06-26,0,0,1628,49,Nkhatabay
27,71,2023-07-03,0,0,1628,49,Nkhatabay
28,72,2023-07-10,0,0,1628,49,Nkhatabay
29,73,2023-07-17,0,0,1628,49,Nkhatabay
30,74,2023-07-24,0,0,1628,49,Nkhatabay
31,75,2023-07-31,0,0,1628,49,Nkhatabay
32,76,2023-08-07,0,0,1628,49,Nkhatabay
33,77,2023-08-14,0,0,1628,49,Nkhatabay
34,78,2023-08-21,0,0,1628,49,Nkhatabay
35,79,2023-08-28,0,0,1628,49,Nkhatabay
36,80,2023-09-04,0,0,1628,49,Nkhatabay
37,81,2023-09-11,0,0,1628,49,Nkhatabay
38,82,2023-09-18,0,0,1628,49,Nkhatabay
39,83,2023-09-25,0,0,1628,49,Nkhatabay
40,84,2023-10-02,0,0,1628,49,Nkhatabay
41,85,2023-10-09,0,0,1628,49,Nkhatabay
42,86,2023-10-16,0,0,1628,49,Nkhatabay
43,87,2023-10-23,0,0,1628,49,Nkhatabay
32,24,2022-08-08,6,0,6,0,Nkhotakota
33,25,2022-08-15,41,2,47,2,Nkhotakota
34,26,2022-08-22,55,1,102,3,Nkhotakota
35,27,2022-08-29,130,1,232,4,Nkhotakota
36,28,2022-09-05,42,2,274,6,Nkhotakota
37,29,2022-09-12,51,2,325,8,Nkhotakota
38,30,2022-09-19,24,3,349,11,Nkhotakota
39,31,2022-09-26,47,2,396,13,Nkhotakota
40,32,2022-10-03,91,4,487,17,Nkhotakota
41,33,2022-10-10,127,13,614,30,Nkhotakota
42,34,2022-10-17,89,5,703,35,Nkhotakota
43,35,2022-10-24,88,5,791,40,Nkhotakota
44,36,2022-10-31,72,1,863,41,Nkhotakota
45,37,2022-11-07,80,2,943,43,Nkhotakota
46,38,2022-11-14,92,2,1035,45,Nkhotakota
47,39,2022-11-21,51,1,1086,46,Nkhotakota
48,40,2022-11-28,36,3,1122,49,Nkhotakota
49,41,2022-12-05,25,0,1147,49,Nkhotakota
50,42,2022-12-12,10,0,1157,49,Nkhotakota
51,43,2022-12-19,11,0,1168,49,Nkhotakota
52,44,2022-12-26,31,1,1199,50,Nkhotakota
1,45,2023-01-02,8,1,1207,51,Nkhotakota
2,46,2023-01-09,15,0,1222,51,Nkhotakota
3,47,2023-01-16,37,0,1259,51,Nkhotakota
4,48,2023-01-23,28,0,1287,51,Nkhotakota
5,49,2023-01-30,20,1,1307,52,Nkhotakota
6,50,2023-02-06,15,0,1322,52,Nkhotakota
7,51,2023-02-13,22,2,1344,54,Nkhotakota
8,52,2023-02-20,11,1,1355,55,Nkhotakota
9,53,2023-02-27,35,1,1390,56,Nkhotakota
10,54,2023-03-06,23,0,1413,56,Nkhotakota
11,55,2023-03-13,17,0,1430,56,Nkhotakota
12,56,2023-03-20,12,0,1442,56,Nkhotakota
13,57,2023-03-27,13,0,1455,56,Nkhotakota
14,58,2023-04-03,0,0,1455,56,Nkhotakota
15,59,2023-04-10,2,0,1457,56,Nkhotakota
16,60,2023-04-17,1,0,1458,56,Nkhotakota
17,61,2023-04-24,1,0,1459,56,Nkhotakota
18,62,2023-05-01,2,0,1461,56,Nkhotakota
19,63,2023-05-08,0,0,1461,56,Nkhotakota
20,64,2023-05-15,0,0,1461,56,Nkhotakota
21,65,2023-05-22,0,0,1461,56,Nkhotakota
22,66,2023-05-29,0,0,1461,56,Nkhotakota
23,67,2023-06-05,0,0,1461,56,Nkhotakota
24,68,2023-06-12,0,0,1461,56,Nkhotakota
25,69,2023-06-19,0,0,1461,56,Nkhotakota
26,70,2023-06-26,0,0,1461,56,Nkhotakota
27,71,2023-07-03,0,0,1461,56,Nkhotakota
28,72,2023-07-10,0,0,1461,56,Nkhotakota
29,73,2023-07-17,0,0,1461,56,Nkhotakota
30,74,2023-07-24,0,0,1461,56,Nkhotakota
31,75,2023-07-31,0,0,1461,56,Nkhotakota
32,76,2023-08-07,0,0,1461,56,Nkhotakota
33,77,2023-08-14,0,0,1461,56,Nkhotakota
34,78,2023-08-21,0,0,1461,56,Nkhotakota
35,79,2023-08-28,0,0,1461,56,Nkhotakota
36,80,2023-09-04,0,0,1461,56,Nkhotakota
37,81,2023-09-11,0,0,1461,56,Nkhotakota
38,82,2023-09-18,1,0,1462,56,Nkhotakota
39,83,2023-09-25,0,0,1462,56,Nkhotakota
40,84,2023-10-02,0,0,1462,56,Nkhotakota
41,85,2023-10-09,2,0,1464,56,Nkhotakota
42,86,2023-10-16,1,0,1465,56,Nkhotakota
43,87,2023-10-23,0,0,1465,56,Nkhotakota
10,2,2022-03-07,1,0,1,0,Nsanje
11,3,2022-03-14,21,1,22,1,Nsanje
12,4,2022-03-21,10,0,32,1,Nsanje
13,5,2022-03-28,22,1,54,2,Nsanje
14,6,2022-04-04,15,1,69,3,Nsanje
15,7,2022-04-11,2,0,71,3,Nsanje
16,8,2022-04-18,2,0,73,3,Nsanje
17,9,2022-04-25,7,0,80,3,Nsanje
18,10,2022-05-02,6,1,86,4,Nsanje
19,11,2022-05-09,24,3,110,7,Nsanje
20,12,2022-05-16,43,1,153,8,Nsanje
21,13,2022-05-23,25,0,178,8,Nsanje
22,14,2022-05-30,15,1,193,9,Nsanje
23,15,2022-06-06,9,0,202,9,Nsanje
24,16,2022-06-13,11,1,213,10,Nsanje
25,17,2022-06-20,6,0,219,10,Nsanje
26,18,2022-06-27,13,2,232,12,Nsanje
27,19,2022-07-04,9,0,241,12,Nsanje
28,20,2022-07-11,6,0,247,12,Nsanje
29,21,2022-07-18,11,0,258,12,Nsanje
30,22,2022-07-25,7,1,265,13,Nsanje
31,23,2022-08-01,8,0,273,13,Nsanje
32,24,2022-08-08,0,0,273,13,Nsanje
33,25,2022-08-15,2,1,275,14,Nsanje
34,26,2022-08-22,0,0,275,14,Nsanje
35,27,2022-08-29,0,0,275,14,Nsanje
36,28,2022-09-05,0,0,275,14,Nsanje
37,29,2022-09-12,0,0,275,14,Nsanje
38,30,2022-09-19,2,0,277,14,Nsanje
39,31,2022-09-26,3,0,280,14,Nsanje
40,32,2022-10-03,0,0,280,14,Nsanje
41,33,2022-10-10,1,0,281,14,Nsanje
42,34,2022-10-17,0,0,281,14,Nsanje
43,35,2022-10-24,0,0,281,14,Nsanje
44,36,2022-10-31,0,0,281,14,Nsanje
45,37,2022-11-07,0,0,281,14,Nsanje
46,38,2022-11-14,0,0,281,14,Nsanje
47,39,2022-11-21,0,0,281,14,Nsanje
48,40,2022-11-28,1,0,282,14,Nsanje
49,41,2022-12-05,1,0,283,14,Nsanje
50,42,2022-12-12,1,0,284,14,Nsanje
51,43,2022-12-19,2,0,286,14,Nsanje
52,44,2022-12-26,3,0,289,14,Nsanje
1,45,2023-01-02,4,0,293,14,Nsanje
2,46,2023-01-09,2,0,295,14,Nsanje
3,47,2023-01-16,9,1,304,15,Nsanje
4,48,2023-01-23,15,0,319,15,Nsanje
5,49,2023-01-30,18,0,337,15,Nsanje
6,50,2023-02-06,16,0,353,15,Nsanje
7,51,2023-02-13,11,1,364,16,Nsanje
8,52,2023-02-20,11,0,375,16,Nsanje
9,53,2023-02-27,36,0,411,16,Nsanje
10,54,2023-03-06,16,0,427,16,Nsanje
11,55,2023-03-13,17,0,444,16,Nsanje
12,56,2023-03-20,23,0,467,16,Nsanje
13,57,2023-03-27,10,0,477,16,Nsanje
14,58,2023-04-03,8,1,485,17,Nsanje
15,59,2023-04-10,7,0,492,17,Nsanje
16,60,2023-04-17,7,0,499,17,Nsanje
17,61,2023-04-24,27,4,526,21,Nsanje
18,62,2023-05-01,29,0,555,21,Nsanje
19,63,2023-05-08,35,0,590,21,Nsanje
20,64,2023-05-15,20,0,610,21,Nsanje
21,65,2023-05-22,5,0,615,21,Nsanje
22,66,2023-05-29,2,0,617,21,Nsanje
23,67,2023-06-05,2,0,619,21,Nsanje
24,68,2023-06-12,4,0,623,21,Nsanje
25,69,2023-06-19,9,0,632,21,Nsanje
26,70,2023-06-26,5,0,637,21,Nsanje
27,71,2023-07-03,5,0,642,21,Nsanje
28,72,2023-07-10,1,0,643,21,Nsanje
29,73,2023-07-17,0,0,643,21,Nsanje
30,74,2023-07-24,0,0,643,21,Nsanje
31,75,2023-07-31,0,0,643,21,Nsanje
32,76,2023-08-07,0,0,643,21,Nsanje
33,77,2023-08-14,1,0,644,21,Nsanje
34,78,2023-08-21,6,0,650,21,Nsanje
35,79,2023-08-28,2,0,652,21,Nsanje
36,80,2023-09-04,5,0,657,21,Nsanje
37,81,2023-09-11,7,0,664,21,Nsanje
38,82,2023-09-18,2,0,666,21,Nsanje
39,83,2023-09-25,5,0,671,21,Nsanje
40,84,2023-10-02,5,0,676,21,Nsanje
41,85,2023-10-09,11,0,687,21,Nsanje
42,86,2023-10-16,3,0,690,21,Nsanje
43,87,2023-10-23,0,0,690,21,Nsanje
38,30,2022-09-19,1,0,1,0,Ntcheu
39,31,2022-09-26,3,0,4,0,Ntcheu
40,32,2022-10-03,1,0,5,0,Ntcheu
41,33,2022-10-10,9,0,14,0,Ntcheu
42,34,2022-10-17,13,0,27,0,Ntcheu
43,35,2022-10-24,4,0,31,0,Ntcheu
44,36,2022-10-31,8,0,39,0,Ntcheu
45,37,2022-11-07,13,0,52,0,Ntcheu
46,38,2022-11-14,46,1,98,1,Ntcheu
47,39,2022-11-21,37,0,135,1,Ntcheu
48,40,2022-11-28,45,4,180,5,Ntcheu
49,41,2022-12-05,49,0,229,5,Ntcheu
50,42,2022-12-12,73,0,302,5,Ntcheu
51,43,2022-12-19,17,0,319,5,Ntcheu
52,44,2022-12-26,47,0,366,5,Ntcheu
1,45,2023-01-02,273,3,639,8,Ntcheu
2,46,2023-01-09,119,2,758,10,Ntcheu
3,47,2023-01-16,151,1,909,11,Ntcheu
4,48,2023-01-23,229,5,1138,16,Ntcheu
5,49,2023-01-30,291,6,1429,22,Ntcheu
6,50,2023-02-06,47,8,1476,30,Ntcheu
7,51,2023-02-13,63,4,1539,34,Ntcheu
8,52,2023-02-20,67,10,1606,44,Ntcheu
9,53,2023-02-27,88,3,1694,47,Ntcheu
10,54,2023-03-06,66,2,1760,49,Ntcheu
11,55,2023-03-13,71,7,1831,56,Ntcheu
12,56,2023-03-20,36,0,1867,56,Ntcheu
13,57,2023-03-27,11,0,1878,56,Ntcheu
14,58,2023-04-03,18,0,1896,56,Ntcheu
15,59,2023-04-10,17,0,1913,56,Ntcheu
16,60,2023-04-17,6,0,1919,56,Ntcheu
17,61,2023-04-24,2,0,1921,56,Ntcheu
18,62,2023-05-01,2,0,1923,56,Ntcheu
19,63,2023-05-08,3,0,1926,56,Ntcheu
20,64,2023-05-15,0,0,1926,56,Ntcheu
21,65,2023-05-22,0,0,1926,56,Ntcheu
22,66,2023-05-29,0,0,1926,56,Ntcheu
23,67,2023-06-05,0,0,1926,56,Ntcheu
24,68,2023-06-12,5,0,1931,56,Ntcheu
25,69,2023-06-19,3,0,1934,56,Ntcheu
26,70,2023-06-26,2,0,1936,56,Ntcheu
27,71,2023-07-03,1,0,1937,56,Ntcheu
28,72,2023-07-10,0,0,1937,56,Ntcheu
29,73,2023-07-17,0,0,1937,56,Ntcheu
30,74,2023-07-24,0,0,1937,56,Ntcheu
31,75,2023-07-31,0,0,1937,56,Ntcheu
32,76,2023-08-07,0,0,1937,56,Ntcheu
33,77,2023-08-14,0,0,1937,56,Ntcheu
34,78,2023-08-21,0,0,1937,56,Ntcheu
35,79,2023-08-28,0,0,1937,56,Ntcheu
36,80,2023-09-04,0,0,1937,56,Ntcheu
37,81,2023-09-11,0,0,1937,56,Ntcheu
38,82,2023-09-18,0,0,1937,56,Ntcheu
39,83,2023-09-25,0,0,1937,56,Ntcheu
40,84,2023-10-02,0,0,1937,56,Ntcheu
41,85,2023-10-09,0,0,1937,56,Ntcheu
42,86,2023-10-16,0,0,1937,56,Ntcheu
43,87,2023-10-23,0,0,1937,56,Ntcheu
40,32,2022-10-03,2,0,2,0,Ntchisi
41,33,2022-10-10,1,0,3,0,Ntchisi
42,34,2022-10-17,0,0,3,0,Ntchisi
43,35,2022-10-24,1,0,4,0,Ntchisi
44,36,2022-10-31,2,0,6,0,Ntchisi
45,37,2022-11-07,0,0,6,0,Ntchisi
46,38,2022-11-14,0,0,6,0,Ntchisi
47,39,2022-11-21,0,0,6,0,Ntchisi
48,40,2022-11-28,0,0,6,0,Ntchisi
49,41,2022-12-05,0,0,6,0,Ntchisi
50,42,2022-12-12,0,0,6,0,Ntchisi
51,43,2022-12-19,0,0,6,0,Ntchisi
52,44,2022-12-26,0,0,6,0,Ntchisi
1,45,2023-01-02,4,0,10,0,Ntchisi
2,46,2023-01-09,2,0,12,0,Ntchisi
3,47,2023-01-16,4,0,16,0,Ntchisi
4,48,2023-01-23,1,0,17,0,Ntchisi
5,49,2023-01-30,11,0,28,0,Ntchisi
6,50,2023-02-06,3,0,31,0,Ntchisi
7,51,2023-02-13,3,0,34,0,Ntchisi
8,52,2023-02-20,19,2,53,2,Ntchisi
9,53,2023-02-27,1,0,54,2,Ntchisi
10,54,2023-03-06,8,0,62,2,Ntchisi
11,55,2023-03-13,3,0,65,2,Ntchisi
12,56,2023-03-20,2,0,67,2,Ntchisi
13,57,2023-03-27,1,0,68,2,Ntchisi
14,58,2023-04-03,0,0,68,2,Ntchisi
15,59,2023-04-10,0,0,68,2,Ntchisi
16,60,2023-04-17,0,0,68,2,Ntchisi
17,61,2023-04-24,0,0,68,2,Ntchisi
18,62,2023-05-01,0,0,68,2,Ntchisi
19,63,2023-05-08,0,0,68,2,Ntchisi
20,64,2023-05-15,0,0,68,2,Ntchisi
21,65,2023-05-22,0,0,68,2,Ntchisi
22,66,2023-05-29,0,0,68,2,Ntchisi
23,67,2023-06-05,0,0,68,2,Ntchisi
24,68,2023-06-12,0,0,68,2,Ntchisi
25,69,2023-06-19,0,0,68,2,Ntchisi
26,70,2023-06-26,0,0,68,2,Ntchisi
27,71,2023-07-03,0,0,68,2,Ntchisi
28,72,2023-07-10,0,0,68,2,Ntchisi
29,73,2023-07-17,0,0,68,2,Ntchisi
30,74,2023-07-24,0,0,68,2,Ntchisi
31,75,2023-07-31,0,0,68,2,Ntchisi
32,76,2023-08-07,0,0,68,2,Ntchisi
33,77,2023-08-14,0,0,68,2,Ntchisi
34,78,2023-08-21,0,0,68,2,Ntchisi
35,79,2023-08-28,0,0,68,2,Ntchisi
36,80,2023-09-04,0,0,68,2,Ntchisi
37,81,2023-09-11,0,0,68,2,Ntchisi
38,82,2023-09-18,0,0,68,2,Ntchisi
39,83,2023-09-25,0,0,68,2,Ntchisi
40,84,2023-10-02,0,0,68,2,Ntchisi
41,85,2023-10-09,0,0,68,2,Ntchisi
42,86,2023-10-16,0,0,68,2,Ntchisi
43,87,2023-10-23,0,0,68,2,Ntchisi
42,34,2022-10-17,36,7,36,7,Phalombe
43,35,2022-10-24,4,0,40,7,Phalombe
44,36,2022-10-31,2,1,42,8,Phalombe
45,37,2022-11-07,1,0,43,8,Phalombe
46,38,2022-11-14,0,0,43,8,Phalombe
47,39,2022-11-21,2,0,45,8,Phalombe
48,40,2022-11-28,0,0,45,8,Phalombe
49,41,2022-12-05,1,0,46,8,Phalombe
50,42,2022-12-12,8,1,54,9,Phalombe
51,43,2022-12-19,7,0,61,9,Phalombe
52,44,2022-12-26,5,0,66,9,Phalombe
1,45,2023-01-02,14,2,80,11,Phalombe
2,46,2023-01-09,9,0,89,11,Phalombe
3,47,2023-01-16,21,0,110,11,Phalombe
4,48,2023-01-23,20,0,130,11,Phalombe
5,49,2023-01-30,38,0,168,11,Phalombe
6,50,2023-02-06,51,0,219,11,Phalombe
7,51,2023-02-13,14,1,233,12,Phalombe
8,52,2023-02-20,32,0,265,12,Phalombe
9,53,2023-02-27,20,1,285,13,Phalombe
10,54,2023-03-06,11,0,296,13,Phalombe
11,55,2023-03-13,0,1,296,14,Phalombe
12,56,2023-03-20,2,0,298,14,Phalombe
13,57,2023-03-27,4,0,302,14,Phalombe
14,58,2023-04-03,0,0,302,14,Phalombe
15,59,2023-04-10,0,0,302,14,Phalombe
16,60,2023-04-17,0,0,302,14,Phalombe
17,61,2023-04-24,0,0,302,14,Phalombe
18,62,2023-05-01,0,0,302,14,Phalombe
19,63,2023-05-08,0,0,302,14,Phalombe
20,64,2023-05-15,0,0,302,14,Phalombe
21,65,2023-05-22,0,0,302,14,Phalombe
22,66,2023-05-29,0,0,302,14,Phalombe
23,67,2023-06-05,0,0,302,14,Phalombe
24,68,2023-06-12,0,0,302,14,Phalombe
25,69,2023-06-19,0,0,302,14,Phalombe
26,70,2023-06-26,0,0,302,14,Phalombe
27,71,2023-07-03,0,0,302,14,Phalombe
28,72,2023-07-10,0,0,302,14,Phalombe
29,73,2023-07-17,0,0,302,14,Phalombe
30,74,2023-07-24,0,0,302,14,Phalombe
31,75,2023-07-31,0,0,302,14,Phalombe
32,76,2023-08-07,0,0,302,14,Phalombe
33,77,2023-08-14,0,0,302,14,Phalombe
34,78,2023-08-21,0,0,302,14,Phalombe
35,79,2023-08-28,0,0,302,14,Phalombe
36,80,2023-09-04,0,0,302,14,Phalombe
37,81,2023-09-11,0,0,302,14,Phalombe
38,82,2023-09-18,0,0,302,14,Phalombe
39,83,2023-09-25,0,0,302,14,Phalombe
40,84,2023-10-02,0,0,302,14,Phalombe
41,85,2023-10-09,0,0,302,14,Phalombe
42,86,2023-10-16,0,0,302,14,Phalombe
43,87,2023-10-23,0,0,302,14,Phalombe
34,26,2022-08-22,5,1,5,1,Rumphi
35,27,2022-08-29,36,1,41,2,Rumphi
36,28,2022-09-05,200,2,241,4,Rumphi
37,29,2022-09-12,89,4,330,8,Rumphi
38,30,2022-09-19,57,2,387,10,Rumphi
39,31,2022-09-26,61,1,448,11,Rumphi
40,32,2022-10-03,74,0,522,11,Rumphi
41,33,2022-10-10,45,0,567,11,Rumphi
42,34,2022-10-17,55,2,622,13,Rumphi
43,35,2022-10-24,70,1,692,14,Rumphi
44,36,2022-10-31,61,2,753,16,Rumphi
45,37,2022-11-07,55,1,808,17,Rumphi
46,38,2022-11-14,30,1,838,18,Rumphi
47,39,2022-11-21,31,0,869,18,Rumphi
48,40,2022-11-28,18,0,887,18,Rumphi
49,41,2022-12-05,16,0,903,18,Rumphi
50,42,2022-12-12,11,0,914,18,Rumphi
51,43,2022-12-19,4,0,918,18,Rumphi
52,44,2022-12-26,0,0,918,18,Rumphi
1,45,2023-01-02,8,0,926,18,Rumphi
2,46,2023-01-09,1,0,927,18,Rumphi
3,47,2023-01-16,1,0,928,18,Rumphi
4,48,2023-01-23,NA,NA,928,18,Rumphi
5,49,2023-01-30,NA,NA,928,18,Rumphi
6,50,2023-02-06,NA,NA,928,18,Rumphi
7,51,2023-02-13,1,0,929,18,Rumphi
8,52,2023-02-20,1,0,930,18,Rumphi
9,53,2023-02-27,0,0,930,18,Rumphi
10,54,2023-03-06,0,0,930,18,Rumphi
11,55,2023-03-13,0,0,930,18,Rumphi
12,56,2023-03-20,0,0,930,18,Rumphi
13,57,2023-03-27,1,0,931,18,Rumphi
14,58,2023-04-03,0,0,931,18,Rumphi
15,59,2023-04-10,1,0,932,18,Rumphi
16,60,2023-04-17,0,0,932,18,Rumphi
17,61,2023-04-24,0,0,932,18,Rumphi
18,62,2023-05-01,0,0,932,18,Rumphi
19,63,2023-05-08,0,0,932,18,Rumphi
20,64,2023-05-15,0,0,932,18,Rumphi
21,65,2023-05-22,0,0,932,18,Rumphi
22,66,2023-05-29,0,0,932,18,Rumphi
23,67,2023-06-05,0,0,932,18,Rumphi
24,68,2023-06-12,0,0,932,18,Rumphi
25,69,2023-06-19,0,0,932,18,Rumphi
26,70,2023-06-26,0,0,932,18,Rumphi
27,71,2023-07-03,0,0,932,18,Rumphi
28,72,2023-07-10,0,0,932,18,Rumphi
29,73,2023-07-17,0,0,932,18,Rumphi
30,74,2023-07-24,0,0,932,18,Rumphi
31,75,2023-07-31,0,0,932,18,Rumphi
32,76,2023-08-07,0,0,932,18,Rumphi
33,77,2023-08-14,0,0,932,18,Rumphi
34,78,2023-08-21,0,0,932,18,Rumphi
35,79,2023-08-28,0,0,932,18,Rumphi
36,80,2023-09-04,0,0,932,18,Rumphi
37,81,2023-09-11,0,0,932,18,Rumphi
38,82,2023-09-18,0,0,932,18,Rumphi
39,83,2023-09-25,0,0,932,18,Rumphi
40,84,2023-10-02,0,0,932,18,Rumphi
41,85,2023-10-09,0,0,932,18,Rumphi
42,86,2023-10-16,0,0,932,18,Rumphi
43,87,2023-10-23,0,0,932,18,Rumphi
41,33,2022-10-10,91,0,91,0,Salima
42,34,2022-10-17,121,2,212,2,Salima
43,35,2022-10-24,126,1,338,3,Salima
44,36,2022-10-31,227,7,565,10,Salima
45,37,2022-11-07,207,13,772,23,Salima
46,38,2022-11-14,152,9,924,32,Salima
47,39,2022-11-21,166,4,1090,36,Salima
48,40,2022-11-28,158,1,1248,37,Salima
49,41,2022-12-05,137,1,1385,38,Salima
50,42,2022-12-12,106,3,1491,41,Salima
51,43,2022-12-19,108,1,1599,42,Salima
52,44,2022-12-26,185,6,1784,48,Salima
1,45,2023-01-02,235,8,2019,56,Salima
2,46,2023-01-09,184,2,2203,58,Salima
3,47,2023-01-16,197,1,2400,59,Salima
4,48,2023-01-23,174,6,2574,65,Salima
5,49,2023-01-30,218,6,2792,71,Salima
6,50,2023-02-06,137,7,2929,78,Salima
7,51,2023-02-13,163,6,3092,84,Salima
8,52,2023-02-20,147,5,3239,89,Salima
9,53,2023-02-27,118,2,3357,91,Salima
10,54,2023-03-06,109,2,3466,93,Salima
11,55,2023-03-13,48,3,3514,96,Salima
12,56,2023-03-20,21,0,3535,96,Salima
13,57,2023-03-27,12,1,3547,97,Salima
14,58,2023-04-03,14,0,3561,97,Salima
15,59,2023-04-10,15,0,3576,97,Salima
16,60,2023-04-17,3,0,3579,97,Salima
17,61,2023-04-24,1,0,3580,97,Salima
18,62,2023-05-01,4,0,3584,97,Salima
19,63,2023-05-08,3,0,3587,97,Salima
20,64,2023-05-15,7,0,3594,97,Salima
21,65,2023-05-22,3,0,3597,97,Salima
22,66,2023-05-29,2,0,3599,97,Salima
23,67,2023-06-05,0,0,3599,97,Salima
24,68,2023-06-12,0,0,3599,97,Salima
25,69,2023-06-19,0,0,3599,97,Salima
26,70,2023-06-26,0,0,3599,97,Salima
27,71,2023-07-03,0,0,3599,97,Salima
28,72,2023-07-10,0,0,3599,97,Salima
29,73,2023-07-17,0,0,3599,97,Salima
30,74,2023-07-24,0,0,3599,97,Salima
31,75,2023-07-31,0,0,3599,97,Salima
32,76,2023-08-07,0,0,3599,97,Salima
33,77,2023-08-14,0,0,3599,97,Salima
34,78,2023-08-21,0,0,3599,97,Salima
35,79,2023-08-28,0,0,3599,97,Salima
36,80,2023-09-04,0,0,3599,97,Salima
37,81,2023-09-11,0,0,3599,97,Salima
38,82,2023-09-18,0,0,3599,97,Salima
39,83,2023-09-25,0,0,3599,97,Salima
40,84,2023-10-02,0,0,3599,97,Salima
41,85,2023-10-09,0,0,3599,97,Salima
42,86,2023-10-16,0,0,3599,97,Salima
43,87,2023-10-23,0,0,3599,97,Salima
42,34,2022-10-17,11,1,11,1,Thyolo
43,35,2022-10-24,28,0,39,1,Thyolo
44,36,2022-10-31,11,1,50,2,Thyolo
45,37,2022-11-07,2,0,52,2,Thyolo
46,38,2022-11-14,1,0,53,2,Thyolo
47,39,2022-11-21,11,0,64,2,Thyolo
48,40,2022-11-28,0,0,64,2,Thyolo
49,41,2022-12-05,2,0,66,2,Thyolo
50,42,2022-12-12,0,0,66,2,Thyolo
51,43,2022-12-19,11,0,77,2,Thyolo
52,44,2022-12-26,76,2,153,4,Thyolo
1,45,2023-01-02,175,4,328,8,Thyolo
2,46,2023-01-09,184,4,512,12,Thyolo
3,47,2023-01-16,178,3,690,15,Thyolo
4,48,2023-01-23,172,3,862,18,Thyolo
5,49,2023-01-30,147,4,1009,22,Thyolo
6,50,2023-02-06,121,3,1130,25,Thyolo
7,51,2023-02-13,112,5,1242,30,Thyolo
8,52,2023-02-20,72,0,1314,30,Thyolo
9,53,2023-02-27,67,1,1381,31,Thyolo
10,54,2023-03-06,67,1,1448,32,Thyolo
11,55,2023-03-13,25,3,1473,35,Thyolo
12,56,2023-03-20,21,0,1494,35,Thyolo
13,57,2023-03-27,19,0,1513,35,Thyolo
14,58,2023-04-03,5,0,1518,35,Thyolo
15,59,2023-04-10,0,0,1518,35,Thyolo
16,60,2023-04-17,1,0,1519,35,Thyolo
17,61,2023-04-24,1,1,1520,36,Thyolo
18,62,2023-05-01,0,0,1520,36,Thyolo
19,63,2023-05-08,0,0,1520,36,Thyolo
20,64,2023-05-15,0,0,1520,36,Thyolo
21,65,2023-05-22,0,0,1520,36,Thyolo
22,66,2023-05-29,0,0,1520,36,Thyolo
23,67,2023-06-05,0,0,1520,36,Thyolo
24,68,2023-06-12,0,0,1520,36,Thyolo
25,69,2023-06-19,1,1,1521,37,Thyolo
26,70,2023-06-26,0,0,1521,37,Thyolo
27,71,2023-07-03,0,0,1521,37,Thyolo
28,72,2023-07-10,0,0,1521,37,Thyolo
29,73,2023-07-17,0,0,1521,37,Thyolo
30,74,2023-07-24,0,0,1521,37,Thyolo
31,75,2023-07-31,0,0,1521,37,Thyolo
32,76,2023-08-07,0,0,1521,37,Thyolo
33,77,2023-08-14,0,0,1521,37,Thyolo
34,78,2023-08-21,0,0,1521,37,Thyolo
35,79,2023-08-28,0,0,1521,37,Thyolo
36,80,2023-09-04,0,0,1521,37,Thyolo
37,81,2023-09-11,0,0,1521,37,Thyolo
38,82,2023-09-18,1,0,1522,37,Thyolo
39,83,2023-09-25,0,0,1522,37,Thyolo
40,84,2023-10-02,0,0,1522,37,Thyolo
41,85,2023-10-09,0,0,1522,37,Thyolo
42,86,2023-10-16,6,0,1528,37,Thyolo
43,87,2023-10-23,4,0,1532,37,Thyolo
34,26,2022-08-22,1,0,1,0,Zomba
35,27,2022-08-29,0,0,1,0,Zomba
36,28,2022-09-05,0,0,1,0,Zomba
37,29,2022-09-12,1,0,2,0,Zomba
38,30,2022-09-19,0,0,2,0,Zomba
39,31,2022-09-26,1,0,3,0,Zomba
40,32,2022-10-03,1,0,4,0,Zomba
41,33,2022-10-10,0,0,4,0,Zomba
42,34,2022-10-17,0,0,4,0,Zomba
43,35,2022-10-24,0,0,4,0,Zomba
44,36,2022-10-31,2,0,6,0,Zomba
45,37,2022-11-07,4,0,10,0,Zomba
46,38,2022-11-14,1,0,11,0,Zomba
47,39,2022-11-21,0,0,11,0,Zomba
48,40,2022-11-28,0,0,11,0,Zomba
49,41,2022-12-05,0,0,11,0,Zomba
50,42,2022-12-12,1,0,12,0,Zomba
51,43,2022-12-19,3,0,15,0,Zomba
52,44,2022-12-26,26,4,41,4,Zomba
1,45,2023-01-02,72,4,113,8,Zomba
2,46,2023-01-09,133,4,246,12,Zomba
3,47,2023-01-16,119,6,365,18,Zomba
4,48,2023-01-23,56,0,421,18,Zomba
5,49,2023-01-30,42,2,463,20,Zomba
6,50,2023-02-06,22,1,485,21,Zomba
7,51,2023-02-13,29,0,514,21,Zomba
8,52,2023-02-20,76,2,590,23,Zomba
9,53,2023-02-27,35,0,625,23,Zomba
10,54,2023-03-06,17,0,642,23,Zomba
11,55,2023-03-13,19,1,661,24,Zomba
12,56,2023-03-20,13,1,674,25,Zomba
13,57,2023-03-27,20,1,694,26,Zomba
14,58,2023-04-03,12,0,706,26,Zomba
15,59,2023-04-10,11,0,717,26,Zomba
16,60,2023-04-17,25,0,742,26,Zomba
17,61,2023-04-24,9,0,751,26,Zomba
18,62,2023-05-01,1,1,752,27,Zomba
19,63,2023-05-08,5,1,757,28,Zomba
20,64,2023-05-15,3,0,760,28,Zomba
21,65,2023-05-22,1,0,761,28,Zomba
22,66,2023-05-29,0,0,761,28,Zomba
23,67,2023-06-05,0,0,761,28,Zomba
24,68,2023-06-12,0,0,761,28,Zomba
25,69,2023-06-19,0,0,761,28,Zomba
26,70,2023-06-26,0,0,761,28,Zomba
27,71,2023-07-03,2,2,763,30,Zomba
28,72,2023-07-10,0,0,763,30,Zomba
29,73,2023-07-17,0,0,763,30,Zomba
30,74,2023-07-24,0,0,763,30,Zomba
31,75,2023-07-31,1,0,764,30,Zomba
32,76,2023-08-07,0,0,764,30,Zomba
33,77,2023-08-14,0,0,764,30,Zomba
34,78,2023-08-21,0,0,764,30,Zomba
35,79,2023-08-28,0,0,764,30,Zomba
36,80,2023-09-04,0,0,764,30,Zomba
37,81,2023-09-11,0,0,764,30,Zomba
38,82,2023-09-18,0,0,764,30,Zomba
39,83,2023-09-25,0,0,764,30,Zomba
40,84,2023-10-02,0,0,764,30,Zomba
41,85,2023-10-09,0,0,764,30,Zomba
42,86,2023-10-16,0,0,764,30,Zomba
43,87,2023-10-23,0,0,764,30,Zomba
